Hh, Hh, Hh, Gs^Fp, Hh, Gs^Fp, Hh, Gs^Fp, Gg, Gg, Gg, Gg, Gs^Fp, Gg, Gs^Fp, Gg, Gs^Fp, Gg, Gg, Gg, Gs^Fp, Gg, Hh, Hh, Hh, Hh
Hh, Hh, Hh, Gs^Fp, Hh, Gs^Fp, Hh, Gs^Fp, Gg, Gg, Gg, Gg, Gs^Fp, Gg, Gs^Fp, Gg, Gs^Fp, Gg, Gg, Gg, Gs^Fp, Gg, Hh, Hh, Hh, Hh
Gs^Fp, Gs^Fp, Hh, Hh, Hh, Hh, Mm, Hh, Gg, Gg, Gg, Gs^Fp, Gg, Gs^Fp, Gg, Gs^Fp, Gg, Gs^Fp, Gg, Gs^Fp, Gg, Hh, Hh, Mm, Mm, Mm
Gs^Fp, Gs^Fp, Hh, Hh, Hh, Mm, Hh, Hh, Gs^Fp, Gg, Gs^Fp, Gg^Vh, Gs^Fp, Gg, Gs^Fp, Gs^Fp, Gg, Gg, Gs^Fp, Gs^Fp, Gs^Fp, Hh, Hh, Mm, Mm, Mm
Gs^Fp, Gs^Fp, Gs^Fp, Hh, Gs^Fp, Hh, Gg, Gs^Fp, Gg, Gs^Fp, Gg, Gs^Fp, Gs^Fp, Gg, Gs^Fp, Gs^Fp, Gg, Ce, Gs^Fp, Gs^Fp, Gs^Fp, Gg, Hh, Hh, Hh, Hh
Gs^Fp, Gs^Fp, Gs^Fp, Gs^Fp, Gg, Gg, Gs^Fp, Gs^Fp, Gs^Fp, Gs^Fp, Gs^Fp, Gs^Fp, Gs^Fp, Gs^Fp, Gs^Fp, Gg, Rd, Rd, Rd, Gs^Fp, Gg, Gg, Gg, Hh, Hh, Hh
Gs^Fp, Gs^Fp, Gs^Fp, Gs^Fp, Gs^Fp, Gs^Fp, Gs^Fp, Gg, Gg, Gg, Gs^Fp, Gs^Fp, Gs^Fp, Gs^Fp, Gg, Ce, Rd, Re, Rd, Ce, Gs^Fp, Gg, Gs^Fp, Gg, Hh, Hh
Gg, Gg, Gs^Fp, Gg, Gg, Gg, Gs^Fp, Gg, Gs^Fp, Gg, Gs^Fp, Gs^Fp, Gg, Gg, Gg^Vh, Gg, Rd, Rd, Gs^Fp, Gs^Fp, Gs^Fp, Gs^Fp, Gs^Fp, Gg, Hh, Hh
Gs^Fp, Gs^Fp, Gg, Gg, Gg, Gg, Gs^Fp, Gs^Fp, Gs^Fp, Gg, Gg, Gg, Gg, Gg, Gg, Gg, Rd, Ce, Gg, Gg, Gg, Gs^Fp, Gg, Gg, Gs^Fp, Gs^Fp
Gs^Fp, Gs^Fp, Gg, Gg^Vh, Gg, Gs^Fp, Gs^Fp, Gg, Gs^Fp, Gg, Hh, Hh, Hh, Gg, Gg, Gs^Fp, Rd, Gs^Fp, Gs^Fp, Gg, Gg^Vh, Gg, Gs^Fp, Gs^Fp, Hh, Hh
Gs^Fp, Gs^Fp, Gs^Fp, Gs^Fp, Gg, Gg, Gg, Gg, Gg, Hh, Hh, Hh, Hh, Gg, Gg, Gs^Fp, Rd, Gs^Fp, Gs^Fp, Gs^Fp, Gs^Fp, Gs^Fp, Hh, Hh, Hh, Hh
Gg, Gg, Gg, Gs^Fp, Gs^Fp, Gg, Gs^Fp, Gs^Fp, Gg, Gs^Fp, Hh, Hh, Gg, Gg, Gg, Gg, Rd, Gs^Fp, Gg, Gg, Gg, Hh, Hh, Hh, Hh, Hh
Gg, Gg, Gg, Gg, Gs^Fp, Gs^Fp, Gg, Gg, Hh, Hh, Hh, Hh, Gg, Gs, Gg, Rd, Gg, Gs^Fp, Gg, Gg, Gg, Hh, Hh, Hh, Gg, Gg
Gs^Fp, Gs^Fp, Gs^Fp, Gg, Gs^Fp, Gg, Gg, Gs^Fp, Hh, Hh, Gg, Gg, Gg^Vh, Gg, Rd, Rd, Gg, Gg, Gg, Gg, Hh, Hh, Hh, Gg, Gs^Fp, Gs^Fp
Gs^Fp, Gs^Fp, Gs^Fp, Gs^Fp, Gs^Fp, Gg, Gg, Hh, Mm, Hh, Gg, Gg, Rd, Rd, Ch, Ch, Ch, Gg, Gg, Gg, Gg, Hh, Gg, Gg, Gs^Fp, Gs^Fp
Gg, Gg, Gs^Fp, Gs^Fp, Gs^Fp, Gg, Hh, Hh, Hh, Hh, Gg, Gg, Rd, Gg, Ch, 3 Kh, Ch, Gg, Gg, Gg, Gs^Fp, Gs^Fp, Gs^Fp, Gg^Vh, Gs^Fp, Gs^Fp
Gg, Gg, Gg, Gs^Fp, Gs^Fp, Gg, Gg, Hh, Mm, Hh, Gg, Gg, Gg, Rd, Rd, Ch, Gg, Gg, Gg, Gs^Fp, Gg, Gg, Gs^Fp, Gs^Fp, Gs^Fp, Gs^Fp
Gg, Gg, Gs^Fp, Gg, Gs^Fp, Gg, Hh, Hh, Hh, Hh, Wwf, Gg, Gg, Gg, Rd, Gg, Gg, Gg, Gs, Gg, Gg, Gg, Gg, Gs^Fp, Gs^Fp, Gs^Fp
Gs^Fp, Gs^Fp, Gs^Fp, Gs^Fp, Gs^Fp, Gg, Hh, Hh, Gg, Gg, Gg, Wwf, Wwf, Gg, Gg, Rd, Gg^Vh, Gs, Gs, Gg, Gg, Gg, Gg, Gg, Gg, Gg
Gs^Fp, Gs^Fp, Gs^Fp, Gg^Vh, Gg, Gg, Hh, Hh, Gg, Gs, Gs, Gg, Gg, Wwf, Gg, Rd, Gg, Gg, Gg, Gg, Gs^Fp, Gs^Fp, Gg^Vh, Gs, Gs, Gs
Gs^Fp, Gs^Fp, Gs^Fp, Gs^Fp, Gg, Hh, Hh, Hh, Gg, Gg^Vh, Gs, Gg, Wwf, Wwf, Gg, Rd, Gg, Gg, Hh, Hh, Gs^Fp, Gs^Fp, Gg, Gs, Gg, Gg
Gg, Gg, Gs^Fp, Gs^Fp, Gg, Gg, Hh, Gg, Gg, Gg, Ww, Ww, Gg, Gg, Rd, Rd, Gg, Gg, Hh, Gg, Gg, Gs^Fp, Hh, Gg, Gg, Gg
Gs^Fp, Gs^Fp, Gg, Gg, Gg, Hh, Hh, Hh, Gg, Ww, Ww, Gg, Gg, Rd, Gg, Gg, Gg, Gg, Hh, Hh, Hh^Vhh, Hh, Gs^Fp, Gg, Gg, Gg
Gs^Fp, Gs^Fp, Gg, Gs^Fp, Gs^Fp, Hh, Hh, Hh, Gg, Ww, Gg, Gg, Gg, Rd, Gg, Gg, Gg, Gg, Gg, Hh, Hh, Hh, Gg, Gs^Fp, Gg, Gg
Gs^Fp, Gs^Fp, Gs^Fp, Gg, Gs^Fp, Hh, Gs^Fp, Hh, Gg, Ww, Gg, Gg, Gg, Rd, Gg, Gg, Gg, Gg, Hh, Hh, Mm, Hh, Gg, Gs^Fp, Gg, Gg
Gg, Gg, Gg, Gg, Gs^Fp, Gs^Fp, Gs^Fp, Hh, Gg, Ww, Ww, Gg, Rd, Rd, Gg, Gg, Gg, Hh, Wwf, Hh, Hh, Hh, Hh, Gs^Fp, Gg, Gg
Gg, Gg, Gg, Gg^Vh, Gs^Fp, Gs^Fp, Hh, Gs^Fp, Gs^Fp, Gg, Gg, Ww, Rd, Gg, Gg, Gg, Gg, Gg, Wwf, Gg, Gg, Hh, Hh, Gs^Fp, Gg, Gg
Hh, Hh, Hh, Gs^Fp, Gs^Fp, Hh, Hh, Hh, Hh, Hh, Gg, Ww, Rd, Gg, Ce, Gg, Gg, Wwf, Gg, Gg, Gs^Fp, Hh, Gg, Gg, Gg, Gg
Hh, Hh, Hh, Gs^Fp, Gg, Gg, Hh, Hh, Gg, Gg, Ww, Ww, Gg, Rd, Gg, Ce, Ce, Wwf, Wwf, Gg, Hh, Hh, Gs^Fp, Gg^Vh, Gg, Gg
Gs^Fp, Gs^Fp, Gg, Gg, Hh, Hh, Gg, Gg, Gg, Ww, Ce, Ce, Gg, Rd, 2 Ke, Gg, Ce, Ce, Wwf, Gg, Hh, Hh, Gs^Fp, Gg, Gg, Gg
Gs^Fp, Gs^Fp, Gs^Fp, Gg, Gg, Gg, Gs, Gg^Vh, Gg, Ww, Ce, Gg^Vh, Gg, Rd, Ce, Ce, Ww, Ww, Gg, Gg, Hh, Hh, Hh, Hh, Gg, Gg
Gs^Fp, Gs^Fp, Gg, Hh, Hh, Gg, Gs, Gg, Gg, Ww, Ww, Ce, Ce, Rd, Ww, Ww, Gg, Gg, Gg, Gg, Hh, Hh, Gs^Fp, Gg, Gg, Gg
Gs^Fp, Gs^Fp, Gg, Hh, Hh, Hh, Gg, Gs, Gg, Gg, Gg, Ww, Ww, Ww^Bw|, Gg, Gg, Gg, Gg, Hh, Hh, Gs^Fp, Hh, Gg, Gg, Gg, Gg
Gs^Fp, Gs^Fp, Gs^Fp, Hh, Hh, Hh, Hh, Gg, Gg, Gg, Ww, Ww, Gg, Rd, Gg, Gg, Gs^Fp, Hh, Gs^Fp, Gs^Fp, Gg, Gg, Gg, Gg, Rd, Rd
Gs^Fp, Gs^Fp, Gs^Fp, Gg, Hh, Hh, Gg, Gg, Gg, Gg, Ww, Gg, Rd, Rd, Gs^Fp, Gs^Fp, Hh, Hh, Gs^Fp, Gg, Gg^Vh, Gg, Rd, Rd, Gg, Gg
Gg, Gg^Vh, Gg, Gg, Gg, Hh, Hh, Gg, Gg, Ww, Gg, Gg, Rd, Gg, Hh, Hh, Gs^Fp, Gs^Fp, Gg, Gg, Rd, Rd, Gg, Gg, Gg, Gg
Gs^Fp, Gs^Fp, Gs^Fp, Rd, Rd, Gg, Hh, Gg, Ww, Ww, Rd, Rd, Gg, Gg, Gg, Hh, Gs, Gg, Gg, Rd, Gs, Gs, Gg, Gg, Gg, Gg
Gs^Fp, Gs^Fp, Gg, Gs^Fp, Gs^Fp, Rd, Rd, Rd, Ww^Bw\, Gg, Rd, Gg, Ce, Gg, Gg, Gg, Gg, Gs, Rd, Rd, Gg, Gg, Gs^Fp, Gg, Gg, Gg
Gs^Fp, Gs^Fp, Gs^Fp, Gs^Fp, Gs^Fp, Gs^Fp, Gs^Fp, Gg, Ww, Rd, Rd, Ce, 1 Ke, Ce, Gg, Gg, Gg^Vh, Gg, Rd, Gg, Gs^Fp, Gs^Fp, Gg, Gs^Fp, Gs^Fp, Gs^Fp
Gs^Fp, Gs^Fp, Gs^Fp, Gs^Fp, Gs^Fp, Gg, Gs^Fp, Ww, Gg, Rd, Rd, Ce, Ce, Ce, Rd, Rd, Rd, Rd, Gs^Fp, Gs^Fp, Gs^Fp, Gg, Gs^Fp, Gs^Fp, Gg, Gg
Gs^Fp, Gs^Fp, Gg, Gs^Fp, Gs^Fp, Gg, Gs^Fp, Gg, Gg, Gg, Gg, Rd, Rd, Rd, Gg, Gg, Gg, Gs^Fp, Gg, Gg, Gg, Gs^Fp, Gg, Gg, Gg, Gg
Gs^Fp, Gs^Fp, Gg, Gs^Fp, Gs^Fp, Gg, Gs^Fp, Gg, Gg, Gg, Gg, Rd, Rd, Rd, Gg, Gg, Gg, Gs^Fp, Gg, Gg, Gg, Gs^Fp, Gg, Gg, Gg, Gg
