Gs^Fp, Gs^Fp, Gs^Fp, Gs^Fp, Gg^Efm, Gg^Efm, Gg^Efm, Gg^Efm, Gs^Fp, Gg^Efm, Gg^Efm, Gg^Efm, Gg^Efm, Gg^Efm, Gs^Fp, Gs^Fp, Gs^Fp, Gs^Fp, Gg^Efm, Gs^Fp, Gg^Efm, Gg^Efm
Gs^Fp, Gs^Fp, Gs^Fp, Gs^Fp, Gg, Gg, Gg, Gg^Efm, Gs^Fp, Gg^Efm, Gg, Gg, Gg, Gg, Gs^Fp, Gs^Fp, Gs^Fp, Gs^Fp, Gg, Gs^Fp, Gg, Gg^Efm
Gg, Gg, Gs^Fp, Gs^Fp, Gg, Gs^Fp, Gg, Gg, Gg, Gg, Gs^Fp, Gs^Fp, Gs^Fp, Gs^Fp, Gg, Gs^Fp, Gs^Fp, Gs^Fp, Ww, Gs^Fp, Gg, Gg
Gs^Fp, Gs^Fp, Gs^Fp, Gg, Gg, Gs^Fp, Gg, Gs^Fp, Gs^Fp, Gs^Fp, Gs^Fp, Gs^Fp, Gs^Fp, Gs^Fp, Gs^Fp, Gs^Fp, Ww, Ww, Ww, Ww, Ww, Ww
Gg, Gg, Gg, Gs^Fp, Gs^Fp, Gg, Gs^Fp, Gs^Fp, Gs^Fp, Gs^Fp, Ww, Gs^Fp, Ww, Gs^Fp, Gs^Fp, Gs^Fp, Ww, Ww, Wo, Ww, Ww, Ww
Gs^Fp, Gs^Fp, Gg, Gs^Fp, Gs^Fp, Gs^Fp, Gs^Fp, Gs^Fp, Gs^Fp, Ww, Ww, Ww, Ww, Ww, Ww, Ww, Ww, Ww, Wo, Wo, Ww, Ww
Gs^Fp, Gs^Fp, Gg^Efm, Gs^Fp, Gg, Gs^Fp, Gg, Gs^Fp, Gs^Fp, Ww, Ce, Ce, Gg, Ww, Ww, Ww, Ww, Wo, Ww, Ww, Ww, Ww
Gg, Gg, Gg^Efm, Gg^Efm, Gs^Fp, Gg, Gs^Fp, Gs^Fp, Ce, Ww, Rd, Rd, Rd, Ce, Ce, Ww, Ww, Ww, Ww, Ww, Gs^Fp, Gs^Fp
Gs^Fp, Gs^Fp, Gg, Gs^Fp, Gs^Fp, Gs^Fp, Gg, Gs^Fp, Rd, Rd, Ww, Ww, Rd, Gg^Vh, Gg, Ce, Ce, Ww, Ce, Ce, Ce, Ce
Rd, Rd, Rd, Gs^Fp, Rd, Rd, Rd, Rd, Gs^Fp, Ce, Ww, Gg, Gg, Gg^Vh, Gs^Fp, Rd, Rd, Ce, Gg^Vh, Gg^Vh, Rd, Rd
Gs^Fp, Gs^Fp, Gs^Fp, Rd, Gs^Fp, Gg, Gs^Fp, Gs^Fp, Ce, Ce, Ww, Gs^Fp, Ww, Gs^Fp, Ww, Ww, Ww, Rd, Rd, Rd, Ce, Ce
Gs^Fp, Gs^Fp, Gs^Fp, Gg, Ss, Gs^Fp, Gs^Fp, Gs^Fp, Ce, Ww, Ww, Ww, Gs^Fp, Ww, Ce, Ww, Ww^Bw/, Ww^Bw/, Ww, Ww, Ww, Ww
Ss, Ss, Ss, Gg, Gg, Gg, Gs^Fp, Gs^Fp, Ce, Ww, Gg^Vh, Gg^Vh, Rd, Gg^Vh, Gg^Vh, Rd, Ce, Ww, Ww, Ww, Ww, Ww
Gs^Fp, Gs^Fp, Gs^Fp, Gs^Fp, Gg^Efm, Gg, Gg, Gs^Fp, Ww, Ww, Rd, Rd, Gs^Fp, Rd, Rd, Rd, Gg^Vh, Ce, Ce, Ww, Gs^Fp, Gs^Fp
Gs^Fp, Gs^Fp, Gs^Fp, Gg, Gs^Fp, Gg, Gs^Fp, Gg, Ww, Ce, Gg^Vh, Rd, Rd, Rd, Gg^Vh, Gg, Gg, Gg, Ce, Ww, Gs^Fp, Gs^Fp
Gs^Fp, Gs^Fp, Ss, Gs^Fp, Gs^Fp, Gs^Fp, Gs^Fp, Gs^Fp, Ww, 1 Ke, Ce, Gg^Vh, Rd, Gg^Vh, Ce, Gs^Fp, Gg, Ce, Ww, Ww, Gs^Fp, Gs^Fp
Gs^Fp, Gs^Fp, Gs^Fp, Gs^Fp, Gs^Fp, Gs^Fp, Gs^Fp, Gs^Fp, Ww, Ww, Ww, Ce, Rd, Ce, Ww, Ce, Ce, 2 Ke, Ww, Gs^Fp, Gs^Fp, Gs^Fp
Ss, Ss, Ss, Ss, Ss, Gs^Fp, Ww, Gs^Fp, Gs^Fp, Ww, Ww, Ww, Ww^Bw|, Ww, Ww, Ww, Ww, Ww, Gs^Fp, Gs^Fp, Gs^Fp, Gs^Fp
Gs^Fp, Gs^Fp, Ss, Gs^Fp, Gs^Fp, Ww, Ww, Ww, Gs^Fp, Gs^Fp, Gs^Fp, Ww, Ww^Bw|, Ww, Ww, Ww, Gs^Fp, Gs^Fp, Hh, Gs^Fp, Hh, Hh
Gs^Fp, Gs^Fp, Gs^Fp, Gs^Fp, Gs^Fp, Gs^Fp, Gs^Fp, Gg, Gs^Fp, Gs^Fp, Gs^Fp, Ww, Rd, Ww, Gg, Gs^Fp, Gs^Fp, Hh, Hh, Hh, Gg, Gg
Gs^Fp, Gs^Fp, Gs^Fp, Ss, Gs^Fp, Gs^Fp, Gs^Fp, Gg, Gs^Fp, Gs^Fp, Gs^Fp, Gg, Rd, Gg, Gs^Fp, Gs^Fp, Gg, Gs^Fp, Gs^Fp, Hh, Gs^Fp, Gs^Fp
Gs^Fp, Gs^Fp, Gs^Fp, Ss, Gs^Fp, Gs^Fp, Gs^Fp, Gg, Gs^Fp, Gs^Fp, Gs^Fp, Gg, Rd, Gg, Gs^Fp, Gs^Fp, Gg, Gs^Fp, Gs^Fp, Hh, Gs^Fp, Gs^Fp
