Gs^Fp, Gs^Fp, Aa^Fpa, Aa^Fpa, Aa, Aa, Aa, Aa, Gs^Fp, Aa, Aa, Aa, Aa, Aa, Aa^Fpa, Aa^Fpa, Aa^Fpa, Aa^Fpa, Aa, Gs^Fp, Aa, Aa
Gs^Fp, Gs^Fp, Aa^Fpa, Aa^Fpa, Aa, Aa, Aa, Aa, Gs^Fp, Aa, Aa, Aa, Aa, Aa, Aa^Fpa, Aa^Fpa, Aa^Fpa, Aa^Fpa, Aa, Gs^Fp, Aa, Aa
Aa, Aa, Gs^Fp, Aa^Fpa, Aa, Gs^Fp, Aa, Aa, Aa, Aa, Aa^Fpa, Aa^Fpa, Aa^Fpa, Gs^Fp, Aa, Aa^Fpa, Aa^Fpa, Aa^Fpa, Ai, Gs^Fp, Aa, Aa
Gs^Fp, Gs^Fp, Gs^Fp, Aa, Aa, Aa^Fpa, Aa, Aa^Fpa, Aa^Fpa, Aa^Fpa, Aa^Fpa, Aa^Fpa, Aa^Fpa, Aa^Fpa, Aa^Fpa, Aa^Fpa, Ai, Ai, Ww, Ai, Ai, Ai
Aa, Aa, Aa, Aa^Fpa, Aa^Fpa, Aa, Aa^Fpa, Aa^Fpa, Aa^Fpa, Aa^Fpa, Ai, Aa^Fpa, Ai, Aa^Fpa, Aa^Fpa, Aa^Fpa, Ai, Ww, Wo, Ww, Ww, Ww
Aa^Fpa, Aa^Fpa, Aa, Aa^Fpa, Aa^Fpa, Aa^Fpa, Aa^Fpa, Aa^Fpa, Aa^Fpa, Ai, Ai, Ai, Ai, Ai, Ai, Ai, Ww, Ww, Wo, Wo, Ww, Ww
Aa^Fpa, Aa^Fpa, Aa, Gs^Fp, Aa, Gs^Fp, Aa, Aa^Fpa, Aa^Fpa, Ai, Cea, Cea, Aa, Ai, Ai, Ww, Ww, Wo, Ww, Ww, Ai, Ai
Aa, Aa, Aa, Aa, Aa^Fpa, Aa, Aa^Fpa, Aa^Fpa, Cea, Ai, Rd, Rd, Rd, Cea, Cea, Ai, Ai, Ww, Ai, Ai, Aa^Fpa, Aa^Fpa
Aa^Fpa, Aa^Fpa, Aa, Aa^Fpa, Aa^Fpa, Aa^Fpa, Aa, Aa^Fpa, Rd, Rd, Ai, Ai, Rd, Aa^Vha, Aa, Cea, Cea, Ai, Cea, Cea, Cea, Cea
Rd, Rd, Aa, Aa^Fpa, Rd, Rd, Rd, Aa, Aa^Fpa, Cea, Ai, Aa, Aa, Aa^Vha, Aa^Fda, Rd, Rd, Cea, Aa^Vha, Aa^Vha, Aa, Aa
Aa^Fpa, Aa^Fpa, Aa^Fpa, Rd, Aa^Fpa, Aa, Aa^Fpa, Aa^Fpa, Cea, Cea, Ai, Aa^Fma, Ai, Aa^Fda, Ai, Ai, Ww, Rd, Rd, Aa, Cea, Cea
Aa^Fpa, Aa^Fpa, Aa^Fpa, Aa, Ss, Aa^Fpa, Aa^Fpa, Aa^Fpa, Cea, Ai, Ai, Ai, Aa^Fda, Ai, Cea, Ai, Ww^Bw/, Ww^Bw/, Ww, Ai, Ai, Ai
Ss, Ss, Ai, Aa, Aa, Aa, Aa^Fpa, Aa^Fpa, Cea, Ai, Aa^Vha, Aa^Vha, Aa, Aa^Vha, Aa^Vha, Rd, Cea, Ai, Ai, Ww, Ai, Ai
Aa^Fpa, Aa^Fpa, Aa^Fpa, Aa^Fpa, Aa, Aa, Aa, Aa^Fpa, Ww, Ww, Aa, Aa, Aa^Fma, Aa, Rd, Aa, Aa^Vha, Cea, Cea, Ai, Aa^Fpa, Aa^Fpa
Aa^Fpa, Aa^Fpa, Aa^Fpa, Aa, Aa^Fpa, Aa, Aa^Fpa, Aa, Ww, Cea, Aa^Vha, Aa, Aa, Aa, Aa^Vha, Aa, Aa, Aa, Cea, Ai, Aa^Fpa, Aa^Fpa
Aa^Fpa, Aa^Fpa, Ss, Aa^Fpa, Aa^Fpa, Aa^Fpa, Aa^Fpa, Aa^Fpa, Ai, 1 Kea, Cea, Aa^Vha, Rd, Aa^Vha, Cea, Aa^Fma, Aa, Cea, Ai, Ai, Aa^Fpa, Aa^Fpa
Aa^Fpa, Aa^Fpa, Aa^Fpa, Aa^Fpa, Aa^Fpa, Aa^Fpa, Aa^Fpa, Aa^Fpa, Ww, Ai, Ai, Cea, Rd, Cea, Ai, Cea, Cea, 2 Kea, Ai, Aa^Fpa, Aa^Fpa, Aa^Fpa
Ss, Ss, Ss, Ai, Ss, Aa^Fpa, Ai, Aa^Fpa, Aa^Fpa, Ww, Ww, Ww, Ww^Bw|, Ai, Ai, Ai, Ai, Ai, Aa^Fpa, Aa^Fpa, Aa^Fpa, Aa^Fpa
Aa^Fpa, Aa^Fpa, Ai, Aa^Fpa, Aa^Fpa, Ai, Ai, Ai, Aa^Fpa, Aa^Fpa, Aa^Fpa, Ww, Ww^Bw|, Ww, Ai, Ai, Aa^Fpa, Aa^Fpa, Ha, Aa^Fpa, Ha, Ha
Aa^Fpa, Aa^Fpa, Aa^Fpa, Aa^Fpa, Aa^Fpa, Aa^Fpa, Aa^Fpa, Aa, Aa^Fpa, Aa^Fpa, Aa^Fpa, Ai, Rd, Ai, Aa, Aa^Fpa, Aa^Fpa, Ha, Ha, Ha, Aa, Aa
Aa^Fpa, Aa^Fpa, Aa^Fpa, Ai, Aa^Fpa, Aa^Fpa, Aa^Fpa, Aa, Aa^Fpa, Aa^Fpa, Aa^Fpa, Aa, Rd, Aa, Aa^Fpa, Aa^Fpa, Aa, Aa^Fpa, Aa^Fpa, Ha, Aa^Fpa, Aa^Fpa
Aa^Fpa, Aa^Fpa, Aa^Fpa, Ai, Aa^Fpa, Aa^Fpa, Aa^Fpa, Aa, Aa^Fpa, Aa^Fpa, Aa^Fpa, Aa, Rd, Aa, Aa^Fpa, Aa^Fpa, Aa, Aa^Fpa, Aa^Fpa, Ha, Aa^Fpa, Aa^Fpa
