border_size=1
usage=map

Gs^Fp       , Gs^Fp       , Gs^Fp       , Gs^Fp       , Gg          , Gg          , Gg          , Gg          , Gs^Fp       , Gg          , Gg          , Gg          , Gg          , Gg          , Gs^Fp       , Gs^Fp       , Gs^Fp       , Gs^Fp       , Gg          , Gs^Fp       , Gg          , Gg          
Gs^Fp       , Gs^Fp       , Gs^Fp       , Gs^Fp       , Gg          , Gg          , Gg          , Gg          , Gs^Fp       , Gg          , Gg          , Gg          , Gg          , Gg          , Gs^Fp       , Gs^Fp       , Gs^Fp       , Gs^Fp       , Gg          , Gs^Fp       , Gg          , Gg          
Gg          , Gg          , Gs^Fp       , Gs^Fp       , Gg          , Gs^Fp       , Gg          , Gg          , Gg          , Gg          , Gs^Fp       , Gs^Fp       , Gs^Fp       , Gs^Fp       , Gg          , Gs^Fp       , Gs^Fp       , Gs^Fp       , Ww          , Gs^Fp       , Gg          , Gg          
Gs^Fp       , Gs^Fp       , Gs^Fp       , Gg          , Gg          , Gs^Fp       , Gg          , Gs^Fp       , Gs^Fp       , Gs^Fp       , Gs^Fp       , Gs^Fp       , Gs^Fp       , Gs^Fp       , Gs^Fp       , Gs^Fp       , Ww          , Ww          , Ww          , Ww          , Ww          , Ww          
Gg          , Gg          , Gg          , Gs^Fp       , Gs^Fp       , Gg          , Gs^Fp       , Gs^Fp       , Gs^Fp       , Gs^Fp       , Ww          , Gs^Fp       , Ww          , Gs^Fp       , Gs^Fp       , Gs^Fp       , Ww          , Ww          , Wo          , Ww          , Ww          , Ww          
Gs^Fp       , Gs^Fp       , Gg          , Gs^Fp       , Gs^Fp       , Gs^Fp       , Gs^Fp       , Gs^Fp       , Gs^Fp       , Ww          , Ww          , Ww          , Ww          , Ww          , Ww          , Ww          , Ww          , Ww          , Wo          , Wo          , Ww          , Ww          
Gs^Fp       , Gs^Fp       , Gg          , Gs^Fp       , Gg          , Gs^Fp       , Gg          , Gs^Fp       , Gs^Fp       , Ww          , Ce          , Ce          , Gg          , Ww          , Ww          , Ww          , Ww          , Wo          , Ww          , Ww          , Ww          , Ww          
Gg          , Gg          , Gg          , Gg          , Gs^Fp       , Gg          , Gs^Fp       , Gs^Fp       , Ce          , Ww          , Rd          , Rd          , Rd          , Ce          , Ce          , Ww          , Ww          , Ww          , Ww          , Ww          , Gs^Fp       , Gs^Fp       
Gs^Fp       , Gs^Fp       , Gg          , Gs^Fp       , Gs^Fp       , Gs^Fp       , Gg          , Gs^Fp       , Rd          , Rd          , Ww          , Ww          , Rd          , Gg          , Gg          , Ce          , Ce          , Ww          , Ce          , Ce          , Ce          , Ce          
Rd          , Rd          , Rd          , Gs^Fp       , Rd          , Rd          , Rd          , Rd          , Gs^Fp       , Ce          , Ww          , Gg          , Re          , Re          , Re          , Rd          , Rd          , Ce          , Re          , Re          , Rd          , Rd          
Gs^Fp       , Gs^Fp       , Gs^Fp       , Rd          , Gs^Fp       , Gg          , Gs^Fp       , Gs^Fp       , Ce          , Ce          , Ww          , Gs^Fp       , Ww          , Gs^Fp       , Ww          , Ww          , Ww          , Rd          , Rd          , Re          , Ce          , Ce          
Gs^Fp       , Gs^Fp       , Gs^Fp       , Gg          , Ss          , Gs^Fp       , Gs^Fp       , Gs^Fp       , Ce          , Ww          , Ww          , Ww          , Re          , Ww          , Ce          , Ww          , Ww^Bw/      , Ww^Bw/      , Ww          , Ww          , Ww          , Ww          
Ss          , Ss          , Ss          , Gg          , Gg          , Gg          , Gs^Fp       , Gs^Fp       , Ce          , Ww          , Re          , Re          , Rd          , Re          , Re          , Rd          , Ce          , Ww          , Ww          , Ww          , Ww          , Ww          
Gs^Fp       , Gs^Fp       , Gs^Fp       , Gs^Fp       , Gg          , Gg          , Re          , Gs^Fp       , Ww          , Ww          , Rd          , Rd          , Re          , Rd          , Rd          , Rd          , Gg          , Ce          , Ce          , Ww          , Gs^Fp       , Gs^Fp       
Gs^Fp       , Gs^Fp       , Gs^Fp       , Gg          , Gs^Fp       , Gg          , Gs^Fp       , Re          , Ww          , Ce          , Re          , Rd          , Rd          , Rd          , Re          , Re          , Re          , Re          , Re          , Ww          , Gs^Fp       , Gs^Fp       
Gs^Fp       , Gs^Fp       , Ss          , Gs^Fp       , Gs^Fp       , Gs^Fp       , Re          , Gs^Fp       , Ww          , 1 Ke        , Ce          , Re          , Rd          , Gg          , Ce          , Gs^Fp       , Gg          , Ce          , Ww          , Ww          , Gs^Fp       , Gs^Fp       
Gs^Fp       , Gs^Fp       , Gs^Fp       , Gs^Fp       , Gs^Fp       , Gs^Fp       , Gs^Fp       , Gs^Fp       , Ww          , Ww          , Ww          , Ce          , Rd          , Re          , Ww          , Ce          , Ce          , 2 Ke        , Ww          , Gs^Fp       , Gs^Fp       , Gs^Fp       
Ss          , Ss          , Ss          , Ss          , Ss          , Gs^Fp       , Ww          , Gs^Fp       , Gs^Fp       , Ww          , Ww          , Ww          , Ww^Bw|      , Ww          , Ww          , Ww          , Ww          , Ww          , Gs^Fp       , Gs^Fp       , Gs^Fp       , Gs^Fp       
Gs^Fp       , Gs^Fp       , Ss          , Gs^Fp       , Gs^Fp       , Ww          , Ww          , Ww          , Gs^Fp       , Gs^Fp       , Gs^Fp       , Ww          , Ww^Bw|      , Ww          , Ww          , Ww          , Gs^Fp       , Gs^Fp       , Hh          , Gs^Fp       , Hh          , Hh          
Gs^Fp       , Gs^Fp       , Gs^Fp       , Gs^Fp       , Gs^Fp       , Gs^Fp       , Gs^Fp       , Gg          , Gs^Fp       , Gs^Fp       , Gs^Fp       , Ww          , Rd          , Ww          , Re          , Gs^Fp       , Gs^Fp       , Hh          , Hh          , Hh          , Gg          , Gg          
Gs^Fp       , Gs^Fp       , Gs^Fp       , Ss          , Gs^Fp       , Gs^Fp       , Gs^Fp       , Gg          , Gs^Fp       , Gs^Fp       , Gs^Fp       , Gg          , Rd          , Re          , Gs^Fp       , Gs^Fp       , Gg          , Gs^Fp       , Gs^Fp       , Hh          , Gs^Fp       , Gs^Fp       
Gs^Fp       , Gs^Fp       , Gs^Fp       , Ss          , Gs^Fp       , Gs^Fp       , Gs^Fp       , Gg          , Gs^Fp       , Gs^Fp       , Gs^Fp       , Gg          , Rd          , Re          , Gs^Fp       , Gs^Fp       , Gg          , Gs^Fp       , Gs^Fp       , Hh          , Gs^Fp       , Gs^Fp       
