border_size=1
usage=map

Gs^Fp       , Gs^Fp       , Aa^Fpa      , Aa^Fpa      , Aa          , Aa          , Aa          , Aa          , Gs^Fp       , Aa          , Aa          , Aa          , Aa          , Aa          , Aa^Fpa      , Aa^Fpa      , Aa^Fpa      , Aa^Fpa      , Aa          , Gs^Fp       , Aa          , Aa          
Gs^Fp       , Gs^Fp       , Aa^Fpa      , Aa^Fpa      , Aa          , Aa          , Aa          , Aa          , Gs^Fp       , Aa          , Aa          , Aa          , Aa          , Aa          , Aa^Fpa      , Aa^Fpa      , Aa^Fpa      , Aa^Fpa      , Aa          , Gs^Fp       , Aa          , Aa          
Aa          , Aa          , Gs^Fp       , Aa^Fpa      , Aa          , Gs^Fp       , Aa          , Aa          , Aa          , Aa          , Aa^Fpa      , Aa^Fpa      , Aa^Fpa      , Gs^Fp       , Aa          , Aa^Fpa      , Aa^Fpa      , Aa^Fpa      , Ai          , Gs^Fp       , Aa          , Aa          
Gs^Fp       , Gs^Fp       , Gs^Fp       , Aa          , Aa          , Aa^Fpa      , Aa          , Aa^Fpa      , Aa^Fpa      , Aa^Fpa      , Aa^Fpa      , Aa^Fpa      , Aa^Fpa      , Aa^Fpa      , Aa^Fpa      , Aa^Fpa      , Ai          , Ai          , Ww          , Ai          , Ai          , Ai          
Aa          , Aa          , Aa          , Aa^Fpa      , Aa^Fpa      , Aa          , Aa^Fpa      , Aa^Fpa      , Aa^Fpa      , Aa^Fpa      , Ai          , Aa^Fpa      , Ai          , Aa^Fpa      , Aa^Fpa      , Aa^Fpa      , Ai          , Ww          , Wo          , Ww          , Ww          , Ww          
Aa^Fpa      , Aa^Fpa      , Aa          , Aa^Fpa      , Aa^Fpa      , Aa^Fpa      , Aa^Fpa      , Aa^Fpa      , Aa^Fpa      , Ai          , Ai          , Ai          , Ai          , Ai          , Ai          , Ai          , Ww          , Ww          , Wo          , Wo          , Ww          , Ww          
Aa^Fpa      , Aa^Fpa      , Aa          , Gs^Fp       , Aa          , Gs^Fp       , Aa          , Aa^Fpa      , Aa^Fpa      , Ai          , Ce          , Ce          , Aa          , Ai          , Ai          , Ww          , Ww          , Wo          , Ww          , Ww          , Ai          , Ai          
Aa          , Aa          , Aa          , Aa          , Aa^Fpa      , Aa          , Aa^Fpa      , Aa^Fpa      , Ce          , Ai          , Rd          , Rd          , Rd          , Ce          , Ce          , Ai          , Ai          , Ww          , Ai          , Ai          , Aa^Fpa      , Aa^Fpa      
Aa^Fpa      , Aa^Fpa      , Aa          , Aa^Fpa      , Aa^Fpa      , Aa^Fpa      , Aa          , Aa^Fpa      , Rd          , Rd          , Ai          , Ai          , Rd          , Aa^Vha      , Aa          , Ce          , Ce          , Ai          , Ce          , Ce          , Ce          , Ce          
Rd          , Rd          , Aa          , Aa^Fpa      , Rd          , Rd          , Rd          , Aa          , Aa^Fpa      , Ce          , Ai          , Aa          , Aa          , Aa^Vha      , Aa^Fda      , Rd          , Rd          , Ce          , Aa^Vha      , Aa^Vha      , Aa          , Aa          
Aa^Fpa      , Aa^Fpa      , Aa^Fpa      , Rd          , Aa^Fpa      , Aa          , Aa^Fpa      , Aa^Fpa      , Ce          , Ce          , Ai          , Aa^Fma      , Ai          , Aa^Fda      , Ai          , Ai          , Ww          , Rd          , Rd          , Aa          , Ce          , Ce          
Aa^Fpa      , Aa^Fpa      , Aa^Fpa      , Aa          , Ss          , Aa^Fpa      , Aa^Fpa      , Aa^Fpa      , Ce          , Ai          , Ai          , Ai          , Aa^Fda      , Ai          , Ce          , Ai          , Ww^Bw/      , Ww^Bw/      , Ww          , Ai          , Ai          , Ai          
Ss          , Ss          , Ai          , Aa          , Aa          , Aa          , Aa^Fpa      , Aa^Fpa      , Ce          , Ai          , Aa^Vha      , Aa^Vha      , Aa          , Aa^Vha      , Aa^Vha      , Rd          , Ce          , Ai          , Ai          , Ww          , Ai          , Ai          
Aa^Fpa      , Aa^Fpa      , Aa^Fpa      , Aa^Fpa      , Aa          , Aa          , Aa          , Aa^Fpa      , Ww          , Ww          , Aa          , Aa          , Aa^Fma      , Aa          , Rd          , Aa          , Aa^Vha      , Ce          , Ce          , Ai          , Aa^Fpa      , Aa^Fpa      
Aa^Fpa      , Aa^Fpa      , Aa^Fpa      , Aa          , Aa^Fpa      , Aa          , Aa^Fpa      , Aa          , Ww          , Ce          , Aa^Vha      , Aa          , Aa          , Aa          , Aa^Vha      , Aa          , Aa          , Aa          , Ce          , Ai          , Aa^Fpa      , Aa^Fpa      
Aa^Fpa      , Aa^Fpa      , Ss          , Aa^Fpa      , Aa^Fpa      , Aa^Fpa      , Aa^Fpa      , Aa^Fpa      , Ai          , 1 Ke        , Ce          , Aa^Vha      , Rd          , Aa^Vha      , Ce          , Aa^Fma      , Aa          , Ce          , Ai          , Ai          , Aa^Fpa      , Aa^Fpa      
Aa^Fpa      , Aa^Fpa      , Aa^Fpa      , Aa^Fpa      , Aa^Fpa      , Aa^Fpa      , Aa^Fpa      , Aa^Fpa      , Ww          , Ai          , Ai          , Ce          , Rd          , Ce          , Ai          , Ce          , Ce          , 2 Ke        , Ai          , Aa^Fpa      , Aa^Fpa      , Aa^Fpa      
Ss          , Ss          , Ss          , Ai          , Ss          , Aa^Fpa      , Ai          , Aa^Fpa      , Aa^Fpa      , Ww          , Ww          , Ww          , Ww^Bw|      , Ai          , Ai          , Ai          , Ai          , Ai          , Aa^Fpa      , Aa^Fpa      , Aa^Fpa      , Aa^Fpa      
Aa^Fpa      , Aa^Fpa      , Ai          , Aa^Fpa      , Aa^Fpa      , Ai          , Ai          , Ai          , Aa^Fpa      , Aa^Fpa      , Aa^Fpa      , Ww          , Ww^Bw|      , Ww          , Ai          , Ai          , Aa^Fpa      , Aa^Fpa      , Ha          , Aa^Fpa      , Ha          , Ha          
Aa^Fpa      , Aa^Fpa      , Aa^Fpa      , Aa^Fpa      , Aa^Fpa      , Aa^Fpa      , Aa^Fpa      , Aa          , Aa^Fpa      , Aa^Fpa      , Aa^Fpa      , Ai          , Rd          , Ai          , Aa          , Aa^Fpa      , Aa^Fpa      , Ha          , Ha          , Ha          , Aa          , Aa          
Aa^Fpa      , Aa^Fpa      , Aa^Fpa      , Ai          , Aa^Fpa      , Aa^Fpa      , Aa^Fpa      , Aa          , Aa^Fpa      , Aa^Fpa      , Aa^Fpa      , Aa          , Rd          , Aa          , Aa^Fpa      , Aa^Fpa      , Aa          , Aa^Fpa      , Aa^Fpa      , Ha          , Aa^Fpa      , Aa^Fpa      
Aa^Fpa      , Aa^Fpa      , Aa^Fpa      , Ai          , Aa^Fpa      , Aa^Fpa      , Aa^Fpa      , Aa          , Aa^Fpa      , Aa^Fpa      , Aa^Fpa      , Aa          , Rd          , Aa          , Aa^Fpa      , Aa^Fpa      , Aa          , Aa^Fpa      , Aa^Fpa      , Ha          , Aa^Fpa      , Aa^Fpa      
