border_size=1
usage=map

Mm          , Mm          , Mm          , Mm          , Mm          , Mm          , Ha          , Ha          , Aa^Fpa      , Aa^Fpa      , Ai          , Ai          , Aa^Fpa      , Aa^Fpa      , Aa^Fpa      , Aa          , Ai          , Ai          , Aa          , Aa          , Rd          , Rd          , Aa          , Aa          , Aa^Fpa      , Aa^Fpa      , Aa          , Aa          , Ce          , Aa^Fpa      , Aa          , Aa          
Mm          , Mm          , Mm          , Mm          , Mm          , Mm          , Ha          , Ha          , Aa^Fpa      , Aa^Fpa      , Ai          , Ai          , Aa^Fpa      , Aa^Fpa      , Aa^Fpa      , Aa          , Ai          , Ai          , Aa          , Aa          , Rd          , Rd          , Aa          , Aa          , Aa^Fpa      , Aa^Fpa      , Aa          , Aa          , Ce          , Aa^Fpa      , Aa          , Aa          
Mm          , Mm          , Mm          , Mm          , Ha          , Ha          , Aa^Fpa      , Aa^Fpa      , Aa^Vha      , Ai          , Ai          , Aa          , Ai          , Ai          , Ai          , Ai          , Re          , Aa          , Rd          , Rd          , Aa          , Aa^Fpa      , Aa^Fpa      , Aa          , Aa^Fpa      , Aa^Fpa      , Aa          , Ce          , Ke          , Ce          , Aa          , Aa          
Mm          , Mm          , Ha          , Ha          , Ha          , Ha          , Aa^Fpa      , Aa          , Ai          , Ai          , Aa          , Ai          , Aa          , Re          , Ce          , Ai          , Ww^Bw/      , Rd          , Re          , Rd          , Rd          , Aa          , Aa          , Aa          , Aa          , Aa          , Rd          , Ce          , Ce          , Ce          , Aa^Fpa      , Aa^Fpa      
Ha          , Ha          , Ha          , Ha          , Aa^Fpa      , Aa^Fpa      , Aa          , Aa          , Ai          , Ai          , Aa          , Aa          , Aa          , Aa          , Rd          , Rd          , Aa^Vha      , Ai          , Ai          , Aa          , Aa          , Rd          , Rd          , Aa^Vha      , Rd          , Rd          , Aa          , Rd          , Rd          , Aa^Fpa      , Aa          , Aa          
Ha          , Ha          , Ha          , Ha          , Ha          , Aa^Fpa      , Aa          , Ai          , Aa^Vha      , Aa          , Aa          , Aa          , Rd          , Rd          , Ha          , Ha          , Aa          , Aa          , Ha          , Ha          , Ha          , Aa          , Aa          , Rd          , Aa          , Aa          , Aa^Fpa      , Aa          , Aa          , Rd          , Aa          , Aa          
Ha          , Ha          , Ha          , Ha          , Ha          , Ha          , Ai          , Ai          , Ce          , Aa          , Ce          , Aa          , Rd          , Ha          , Aa          , Aa          , Aa          , Ha          , Aa          , Aa          , Ha          , Ha          , Ha          , Aa          , Ha          , Aa          , Aa^Fpa      , Aa          , Aa^Fpa      , Rd          , Rd          , Rd          
Mm          , Mm          , Mm          , Mm          , Ha          , Ai          , Aa          , Aa          , Aa          , Ce          , 2 Ke        , Ce          , Rd          , Ha          , Rd          , Aa          , Aa          , Aa          , Ha          , Aa          , Aa          , Ha          , Ha          , Ha          , Aa          , Aa          , Aa^Fpa      , Aa^Fpa      , Aa          , Aa^Vha      , Rd          , Rd          
Mm          , Mm          , Qxu         , Ha          , Ww          , Ai          , Aa          , Aa          , Aa          , Ce          , Ce          , Ce          , Ce          , Rd          , Ha^Vhha     , Rd          , Aa          , Aa          , Ha          , Ha          , Aa          , Aa          , Aa          , Aa          , Ha          , Ha          , Aa          , Aa^Fpa      , Aa          , Aa^Fpa      , Rd          , Rd          
Mm          , Mm          , Mm          , Qxu         , Aa          , Ww          , Aa          , Aa          , Aa          , Aa          , Aa          , Aa          , Aa          , Ha          , Aa          , Rd          , Rd          , Aa          , Ha          , Aa          , Aa          , Aa          , Ha          , Ha          , Aa^Fpa      , Aa          , Aa^Fpa      , Aa^Fpa      , Aa          , Aa          , Rd          , Rd          
Ha          , Ha          , Mm          , Mm          , Ha          , Qxu         , Qxu         , Ha          , Ha          , Ha          , Ha          , Aa          , Aa          , Aa          , Aa          , Aa^Vha      , Rd          , Ce          , Aa          , Aa          , Aa          , Ha          , Aa^Fpa      , Aa^Fpa      , Qxu         , Aa          , Aa^Fpa      , Aa          , Aa          , Aa          , Rd          , Rd          
Mm          , Mm          , Mm          , Hh^Vhh      , Aa          , Ha          , Mm          , Mm          , Mm          , Mm          , Ha          , Ha          , Ha          , Aa          , Aa          , Rd          , Ha          , Ha          , Aa          , Aa          , Qxu         , Ce          , Ai          , Qxu         , Aa          , Aa^Fpa      , Aa          , Aa          , Rd          , Rd          , Aa          , Aa          
Ha          , Ha          , Ha          , Mm          , Aa          , Mm          , Ha          , Mm          , Ha          , Ha          , Mm          , Mm          , Ha          , Ha          , Ha          , Rd          , Ce          , Aa          , Aa          , Aa          , Ha^Vhha     , Qxu         , Aa^Fpa      , Aa^Fpa      , Aa^Fpa      , Aa          , Aa          , Aa          , Rd          , Aa^Vha      , Aa          , Aa          
Mm          , Mm          , Mm          , Aa          , Mm          , Ha          , Mm          , Ha          , Mm          , Mm          , Ha          , Ha          , Qxu         , Qxu         , Rd          , Rd          , Qxu         , Qxu         , Mm          , Ai          , Ha          , Ai          , Aa          , Aa          , Aa          , Aa          , Rd          , Rd          , Aa          , Aa          , Aa^Fpa      , Aa^Fpa      
Ha          , Ha          , Ha          , Aa          , Ha          , Mm          , Ha          , Ha          , Ha          , Ha          , Aa          , Ha          , Rd          , Rd          , Qxu         , Qxu         , Ha          , Ha          , Mm          , Mm          , Ha          , Aa^Fpa      , Mm          , Aa          , Aa^Fpa      , Aa          , Rd          , Aa^Vha      , Aa          , Aa^Fpa      , Aa^Fpa      , Aa^Fpa      
Aa^Fpa      , Aa^Fpa      , Aa          , Aa          , Aa^Fpa      , Ha          , Aa^Fpa      , Aa^Fpa      , Aa          , Aa^Fpa      , Rd          , Rd          , Aa          , Qxu         , Ha          , Ha          , Mm          , Mm          , Ha          , Ha          , Aa^Fpa      , Mm          , Ha          , Ha          , Aa          , Aa          , Rd          , Aa          , Ce          , Aa          , Aa          , Aa          
Aa^Fpa      , Aa^Fpa      , Aa          , Aa          , Aa          , Aa^Fpa      , Aa^Fpa      , Aa          , Aa          , Aa          , Rd          , Aa          , Aa^Fpa      , Aa^Fpa      , Ha          , Ha          , Ha          , Mm          , Aa^Fpa      , Aa          , Aa          , Ha          , Aa          , Aa^Fpa      , Aa          , Aa^Vha      , Rd          , Ce          , 4 Ke        , Ce          , Aa          , Aa          
Aa          , Aa^Vha      , Aa          , Aa          , Ce          , Aa          , Aa          , Aa          , Aa          , Aa          , Rd          , Aa          , Rd          , Ha          , Aa          , Aa^Fpa      , Aa          , Ha          , Rd          , Aa^Vha      , Rd          , Aa          , Rd          , Aa          , Rd          , Rd          , Aa          , Ce          , Ce          , Ce          , Aa          , Aa          
Aa          , Aa          , Aa          , Ce          , 1 Ke        , Ce          , Rd          , Rd          , Rd          , Rd          , Aa^Vha      , Rd          , Qxu         , Rd          , Rd          , Aa          , Rd          , Rd          , Aa          , Rd          , Aa          , Rd          , Aa          , Rd          , Aa^Fpa      , Aa          , Aa          , Aa          , Aa          , Aa          , Aa^Fpa      , Aa^Fpa      
Aa^Fpa      , Aa^Fpa      , Aa          , Ce          , Ce          , Ce          , Aa          , Aa          , Rd          , Aa          , Aa          , Qxu         , Aa^Fpa      , Aa          , Aa          , Rd          , Aa          , Aa          , Aa^Fpa      , Aa          , Aa^Fpa      , Aa          , Aa          , Aa^Fpa      , Aa          , Aa          , Aa^Fpa      , Aa          , Aa          , Aa          , Aa          , Aa          
Aa^Fpa      , Aa^Fpa      , Aa^Fpa      , Aa          , Gg          , Aa^Fpa      , Aa^Fpa      , Aa^Fpa      , Rd          , Aa          , Qxu         , Qxu         , Aa          , Aa^Fpa      , Aa^Fpa      , Aa          , Aa          , Aa          , Gg          , Aa^Fpa      , Aa          , Aa^Fpa      , Aa          , Aa^Fpa      , Aa          , Aa          , Aa^Fpa      , Aa          , Aa          , Aa^Vha      , Aa          , Aa          
Aa^Fpa      , Aa^Fpa      , Aa^Fpa      , Aa          , Gg          , Aa^Fpa      , Aa^Fpa      , Aa^Fpa      , Rd          , Aa          , Qxu         , Qxu         , Aa          , Aa^Fpa      , Aa^Fpa      , Aa          , Aa          , Aa          , Gg          , Aa^Fpa      , Aa          , Aa^Fpa      , Aa          , Aa^Fpa      , Aa          , Aa          , Aa^Fpa      , Aa          , Aa          , Aa          , Aa          , Aa          
