border_size=1
usage=map

Mm          , Mm          , Mm          , Mm          , Mm          , Mm          , Ha          , Ha          , Aa^Fpa      , Aa^Fpa      , Ai          , Ai          , Gs^Fp       , Aa^Fpa      , Gs^Fp       , Gg          , Ai          , Ai          , Gg          , Gg          , Rd          , Rd          , Gg          , Aa          , Aa^Fpa      , Aa^Fpa      , Aa          , Aa          , Ce          , Aa^Fpa      , Gg          , Gg          
Mm          , Mm          , Mm          , Mm          , Mm          , Mm          , Ha          , Ha          , Aa^Fpa      , Aa^Fpa      , Ai          , Ai          , Gs^Fp       , Aa^Fpa      , Gs^Fp       , Gg          , Ai          , Ai          , Gg          , Gg          , Rd          , Rd          , Gg          , Aa          , Aa^Fpa      , Aa^Fpa      , Aa          , Aa          , Ce          , Aa^Fpa      , Gg          , Gg          
Mm          , Mm          , Mm          , Mm          , Hh          , Ha          , Gs^Fp       , Gs^Fp       , Gg^Vh       , Ww          , Ww          , Gg          , Ww          , Ww          , Ww          , Ww          , Re          , Gg          , Rd          , Rd          , Gg          , Aa^Fpa      , Aa^Fpa      , Aa          , Gs^Fp       , Gs^Fp       , Gg          , Ce          , 2 Ke        , Ce          , Aa          , Aa          
Mm          , Mm          , Ha          , Ha          , Hh          , Hh          , Gs^Fp       , Gg          , Ww          , Ww          , Aa          , Ww          , Gg          , Re          , Ce          , Ss          , Ww^Bw/      , Rd          , Re          , Rd          , Rd          , Gg          , Aa          , Aa          , Aa          , Gg          , Rd          , Ce          , Ce          , Ce          , Gs^Fp       , Gs^Fp       
Ha          , Ha          , Hh          , Hh          , Gs^Fp       , Gs^Fp       , Gg          , Aa          , Ww          , Ww          , Gg          , Gg          , Aa          , Gg          , Rd          , Rd          , Gg^Vh       , Ss          , Ss          , Aa          , Aa          , Rd          , Rd          , Aa^Vha      , Rd          , Rd          , Aa          , Rd          , Rd          , Gs^Fp       , Gg          , Gg          
Ha          , Ha          , Ha          , Hh          , Hh          , Gs^Fp       , Gg          , Ww          , Gg^Vh       , Gg          , Gg          , Gg          , Rd          , Rd          , Hh          , Hh          , Gg          , Gg          , Hh          , Hh          , Ha          , Aa          , Aa          , Rd          , Aa          , Aa          , Gs^Fp       , Aa          , Gg          , Rd          , Gg          , Gg          
Ha          , Ha          , Hh          , Ha          , Ha          , Hh          , Ww          , Ww          , Ce          , Gg          , Ce          , Gg          , Rd          , Hh          , Aa          , Gg          , Gs          , Hh          , Aa          , Gg          , Hh          , Hh          , Ha          , Aa          , Hh          , Gg          , Gs^Fp       , Aa          , Gs^Fp       , Rd          , Rd          , Rd          
Mm          , Mm          , Mm          , Mm          , Ha          , Ai          , Aa          , Aa          , Aa          , Ce          , 1 Ke        , Ce          , Rd          , Hh          , Rd          , Gg          , Aa          , Gs          , Hh          , Gg          , Aa          , Ha          , Hh          , Ha          , Gg          , Gg          , Gs^Fp       , Gs^Fp       , Aa          , Gg^Vh       , Rd          , Rd          
Mm          , Mm          , Qxu         , Hh          , Ww          , Ai          , Aa          , Aa          , Aa          , Ce          , Ce          , Ce          , Ce          , Rd          , Hh^Vhh      , Rd          , Aa          , Gs          , Ha          , Hh          , Gg          , Gg          , Gg          , Gg          , Ha          , Ha          , Aa          , Gs^Fp       , Gg          , Aa^Fpa      , Rd          , Rd          
Mm          , Mm          , Mm          , Qxu         , Aa          , Ww          , Aa          , Aa          , Gg          , Aa          , Aa          , Aa          , Aa          , Hh          , Aa          , Rd          , Rd          , Gg          , Hh          , Aa          , Gg          , Gg          , Hh          , Ha          , Gs^Fp       , Aa          , Gs^Fp       , Gs^Fp       , Aa          , Gg          , Rd          , Rd          
Hh          , Hh          , Mm          , Mm          , Hh          , Qxu         , Qxu         , Hh          , Hh          , Hh          , Hh          , Aa          , Aa          , Aa          , Gg          , Gg^Vh       , Rd          , Ce          , Aa          , Aa          , Gg          , Hh          , Gs^Fp       , Gs^Fp       , Qxu         , Aa          , Gs^Fp       , Gg          , Gg          , Gg          , Rd          , Rd          
Mm          , Mm          , Mm          , Hh^Vhh      , Aa          , Hh          , Mm          , Mm          , Mm          , Mm          , Hh          , Hh          , Hh          , Aa          , Aa          , Rd          , Hh          , Hh          , Gg          , Gg          , Qxu         , Ce          , Ss          , Qxu         , Aa          , Gs^Fp       , Gg          , Gg          , Rd          , Rd          , Gg          , Gg          
Hh          , Hh          , Hh          , Mm          , Gg          , Mm          , Ha          , Mm          , Ha          , Ha          , Mm          , Mm          , Hh          , Hh          , Hh          , Rd          , Ce          , Gg          , Aa          , Gg          , Hh^Vhh      , Qxu         , Gs^Fp       , Gs^Fp       , Gs^Fp       , Aa          , Gg          , Gg          , Rd          , Gg^Vh       , Gg          , Gg          
Mm          , Mm          , Mm          , Aa          , Mm          , Ha          , Mm          , Hh          , Mm          , Mm          , Ha          , Hh          , Qxu         , Qxu         , Rd          , Rd          , Qxu         , Qxu         , Mm          , Ss          , Hh          , Ss          , Gg          , Gg          , Gg          , Gg          , Rd          , Rd          , Gg          , Gg          , Gs^Fp       , Gs^Fp       
Hh          , Hh          , Hh          , Gg          , Hh          , Mm          , Hh          , Hh          , Hh          , Hh          , Gg          , Hh          , Rd          , Rd          , Qxu         , Qxu         , Ha          , Ha          , Mm          , Mm          , Ha          , Gs^Fp       , Mm          , Gg          , Gs^Fp       , Gg          , Rd          , Gg^Vh       , Gg          , Gs^Fp       , Gs^Fp       , Gs^Fp       
Aa^Fpa      , Aa^Fpa      , Gg          , Aa          , Gs^Fp       , Hh          , Aa^Fpa      , Aa^Fpa      , Gg          , Gs^Fp       , Rd          , Rd          , Aa          , Qxu         , Hh          , Hh          , Mm          , Mm          , Hh          , Hh          , Gs^Fp       , Mm          , Ha          , Hh          , Gg          , Gg          , Rd          , Gg          , Ce          , Gg          , Gg          , Gg          
Gs^Fp       , Gs^Fp       , Gg          , Gg          , Aa          , Gs^Fp       , Gs^Fp       , Aa          , Gg          , Gg          , Rd          , Gg          , Gs^Fp       , Gs^Fp       , Hh          , Hh          , Ha          , Mm          , Gs^Fp       , Gg          , Gg          , Hh          , Gg          , Gs^Fp       , Gg          , Gg^Vh       , Rd          , Ce          , 4 Ke        , Ce          , Gg          , Gg          
Gg          , Gg^Vh       , Gg          , Gg          , Ce          , Gg          , Gg          , Aa          , Aa          , Aa          , Rd          , Aa          , Rd          , Hh          , Gg          , Gs^Fp       , Gg          , Ha          , Rd          , Gg^Vh       , Rd          , Gg          , Rd          , Gg          , Rd          , Rd          , Gg          , Ce          , Ce          , Ce          , Aa          , Aa          
Aa          , Aa          , Gg          , Ce          , 3 Ke        , Ce          , Rd          , Rd          , Rd          , Rd          , Gg^Vh       , Rd          , Qxu         , Rd          , Rd          , Gg          , Rd          , Rd          , Gg          , Rd          , Gg          , Rd          , Aa          , Rd          , Gs^Fp       , Gg          , Gg          , Gg          , Gg          , Aa          , Gs^Fp       , Gs^Fp       
Gs^Fp       , Gs^Fp       , Gg          , Ce          , Ce          , Ce          , Gg          , Gg          , Rd          , Gg          , Gg          , Qxu         , Gs^Fp       , Gg          , Gg          , Rd          , Gg          , Gg          , Gs^Fp       , Aa          , Gs^Fp       , Aa          , Aa          , Gs^Fp       , Aa          , Aa          , Gs^Fp       , Aa          , Gg          , Aa          , Aa          , Aa          
Gs^Fp       , Gs^Fp       , Gs^Fp       , Aa          , Gg          , Gs^Fp       , Gs^Fp       , Gs^Fp       , Rd          , Aa          , Qxu         , Qxu         , Gg          , Gs^Fp       , Gs^Fp       , Gg          , Aa          , Aa          , Gg          , Gs^Fp       , Gg          , Gs^Fp       , Gg          , Gs^Fp       , Gg          , Gg          , Gs^Fp       , Gg          , Gg          , Gg^Vh       , Gg          , Gg          
Gs^Fp       , Gs^Fp       , Gs^Fp       , Aa          , Gg          , Gs^Fp       , Gs^Fp       , Gs^Fp       , Rd          , Aa          , Qxu         , Qxu         , Gg          , Gs^Fp       , Gs^Fp       , Gg          , Aa          , Aa          , Gg          , Gs^Fp       , Gg          , Gs^Fp       , Gg          , Gs^Fp       , Gg          , Gg          , Gs^Fp       , Gg          , Gg          , Gg          , Gg          , Gg          
