Ms, Ms, Ms, Mm, Ms, Ms, Ha, Ha, Aa^Fpa, Aa^Fpa, Ai, Ai, Aa^Fpa, Aa^Fpa, Aa^Fpa, Aa, Ai, Ai, Aa, Aa, Rd, Rd, Aa, Aa, Aa^Fpa, Aa^Fpa, Aa, Aa, Aa, Aa^Fpa, Aa, Aa
Ms, Ms, Ms, Ms, Ms, Ms, Ha, Ha, Aa^Fpa, Aa^Fpa, Ai, Ai, Aa^Fpa, Aa^Fpa, Aa^Fpa, Aa, Ai, Ai, Aa, Aa, Rd, Rd, Aa, Aa, Aa^Fpa, Aa^Fpa, Aa, Aa, Cea, Aa^Fpa, Aa, Aa
Ms, Ms, Ms, Ms, Ha, Ha, Aa^Fpa, Aa^Fpa, Aa^Vha, Ai, Ai, Aa, Ai, Ai, Ai, Ai, Re, Aa, Rd, Rd, Aa, Aa^Fpa, Aa^Fpa, Aa, Aa^Fpa, Aa^Fpa, Aa, Cea, Kea, Cea, Aa, Aa
Ms, Ms, Ha, Ha, Ha, Ha, Aa^Fpa, Aa, Ai, Ai, Aa, Ai, Aa, Re, Cea, Ai, Ww^Bw/, Rd, Re, Rd, Rd, Aa, Aa, Aa, Aa, Aa, Rd, Cea, Cea, Cea, Aa^Fpa, Aa^Fpa
Ha, Ha, Ha, Ha, Aa^Fpa, Aa^Fpa, Aa, Aa, Ai, Ai, Aa, Aa, Aa, Aa, Rd, Rd, Aa^Vha, Ai, Ai, Aa, Aa, Rd, Rd, Aa^Vha, Rd, Rd, Aa, Rd, Rd, Aa^Fpa, Aa, Aa
Ha, Ha, Ha, Ha, Ha, Aa^Fpa, Aa, Ai, Aa^Vha, Aa, Aa, Aa, Rd, Rd, Ha, Ha, Aa, Aa, Ha, Ha, Ha, Aa, Aa, Rd, Aa, Aa, Aa^Fpa, Aa, Aa, Rd, Aa, Aa
Ha, Ha, Ha, Ha, Ha, Ha, Ai, Ai, Cea, Aa, Cea, Aa, Rd, Ha, Aa, Aa, Aa, Ha, Aa, Aa, Ha, Ha, Ha, Aa, Ha, Aa, Aa^Fpa, Aa, Aa^Fpa, Rd, Rd, Rd
Ms, Ms, Md, Ms, Ha, Ai, Aa, Aa, Aa, Cea, 2 Kea, Cea, Rd, Ha, Rd, Aa, Aa, Aa, Ha, Aa, Aa, Ha, Ha, Ha, Aa, Aa, Aa^Fpa, Aa^Fpa, Aa, Aa^Vha, Rd, Rd
Ms, Md, Qxu, Ha, Ww, Ai, Aa, Aa, Aa, Cea, Cea, Cea, Cea, Rd, Ha^Vhha, Rd, Aa, Aa, Ha, Ha, Aa, Aa, Aa, Aa, Ha, Ha, Aa, Aa^Fpa, Aa, Aa^Fpa, Rd, Rd
Ms, Ms, Ms, Qxu, Aa, Ww, Aa, Aa, Aa, Aa, Aa, Aa, Aa, Ha, Aa, Rd, Rd, Aa, Ha, Aa, Aa, Aa, Ha, Ha, Aa^Fpa, Aa, Aa^Fpa, Aa^Fpa, Aa, Aa, Rd, Rd
Ha, Ha, Ms, Ms, Ha, Qxu, Qxu, Ha, Ha, Ha, Ha, Aa, Aa, Aa, Aa, Aa^Vha, Rd, Cea, Aa, Aa, Aa, Ha, Aa^Fpa, Aa^Fpa, Qxu, Aa, Aa^Fpa, Aa, Aa, Aa, Rd, Rd
Ms, Ms, Ms, Ha^Vhha, Aa, Ha, Ms, Ms, Ms, Ms, Ha, Ha, Ha, Aa, Aa, Rd, Ha, Ha, Aa, Aa, Qxu, Cea, Ai, Qxu, Aa, Aa^Fpa, Aa, Aa, Rd, Rd, Aa, Aa
Ha, Ha, Ha, Ms, Aa, Ms, Ha, Ms, Ha, Ha, Ms, Ms, Ha, Ha, Ha, Rd, Cea, Aa, Aa, Aa, Ha^Vhha, Qxu, Aa^Fpa, Aa^Fpa, Aa^Fpa, Aa, Aa, Aa, Rd, Aa^Vha, Aa, Aa
Ms, Ms, Ms, Aa, Ms, Ha, Ms, Ha, Ms, Ms, Ha, Ha, Qxe, Qxe, Rd, Rd, Qxe, Qxu, Ms, Ai, Ha, Ai, Aa, Aa, Aa, Aa, Rd, Rd, Aa, Aa, Aa^Fpa, Aa^Fpa
Ha, Ha, Ha, Aa, Ha, Ms, Ha, Ha, Ha, Ha, Aa, Ha, Rd, Rd, Qxe, Qxe, Ha, Ha, Ms, Ms, Ha, Aa^Fpa, Ms, Aa, Aa^Fpa, Aa, Rd, Aa^Vha, Aa, Aa^Fpa, Aa^Fpa, Aa^Fpa
Aa^Fpa, Aa^Fpa, Aa, Aa, Aa^Fpa, Ha, Aa^Fpa, Aa^Fpa, Aa, Aa^Fpa, Rd, Rd, Aa, Qxe, Ha, Ha, Ms, Ms, Ha, Ha, Aa^Fpa, Ms, Ha, Ha, Aa, Aa, Rd, Aa, Cea, Aa, Aa, Aa
Aa^Fpa, Aa^Fpa, Aa, Aa, Aa, Aa^Fpa, Aa^Fpa, Aa, Aa, Aa, Rd, Aa, Aa^Fpa, Aa^Fpa, Ha, Ha, Ha, Ms, Aa^Fpa, Aa, Aa, Ha, Aa, Aa^Fpa, Aa, Aa^Vha, Rd, Cea, 4 Kea, Cea, Aa, Aa
Aa, Aa^Vha, Aa, Aa, Cea, Aa, Aa, Aa, Aa, Aa, Rd, Aa, Rd, Ha, Aa, Aa^Fpa, Aa, Ha, Rd, Aa^Vha, Rd, Aa, Rd, Aa, Rd, Rd, Aa, Cea, Cea, Cea, Aa, Aa
Aa, Aa, Aa, Cea, 1 Kea, Cea, Rd, Rd, Rd, Rd, Aa^Vha, Rd, Qxe, Rd, Rd, Aa, Rd, Rd, Aa, Rd, Aa, Rd, Aa, Rd, Aa^Fpa, Aa, Aa, Aa, Aa, Aa, Aa^Fpa, Aa^Fpa
Aa^Fpa, Aa^Fpa, Aa, Cea, Cea, Cea, Aa, Aa, Rd, Aa, Aa, Qxe, Aa^Fpa, Aa, Aa, Rd, Aa, Aa, Aa^Fpa, Aa, Aa^Fpa, Aa, Aa, Aa^Fpa, Aa, Aa, Aa^Fpa, Aa, Aa, Aa, Aa, Aa
Aa^Fpa, Aa^Fpa, Aa^Fpa, Aa, Gg, Aa^Fpa, Aa^Fpa, Aa^Fpa, Rd, Aa, Qxu, Qxu, Aa, Aa^Fpa, Aa^Fpa, Aa, Aa, Aa, Gg, Aa^Fpa, Aa, Aa^Fpa, Aa, Aa^Fpa, Aa, Aa, Aa^Fpa, Aa, Aa, Aa^Vha, Aa, Aa
Aa^Fpa, Aa^Fpa, Aa^Fpa, Aa, Gg, Aa^Fpa, Aa^Fpa, Aa^Fpa, Rd, Aa, Qxu, Qxu, Aa, Aa^Fpa, Aa^Fpa, Aa, Aa, Aa, Gg, Aa^Fpa, Aa, Aa^Fpa, Aa, Aa^Fpa, Aa, Aa, Aa^Fpa, Aa, Aa, Aa, Aa, Aa
