border_size=1
usage=map

Gs^Fp       , Gs^Fp       , Hh          , Hh          , Gg          , Gg          , Gg          , Gg          , Gg          , Rd          , Rd          , Gg          , Gg          , Gg          , Gg          , Gg          , Gg          , Gg          , Gs^Fp       , Gs^Fp       , Hh          , Hh          , Mm          , Gs^Fp       , Hh          , Hh          
Gs^Fp       , Gs^Fp       , Hh          , Hh          , Gg          , Gg          , Gg          , Gg          , Gg          , Rd          , Rd          , Gg          , Gg          , Gg          , Gg          , Gg          , Gg          , Gg          , Gs^Fp       , Gs^Fp       , Hh          , Hh          , Mm          , Gs^Fp       , Hh          , Hh          
Gs^Fp       , Gs^Fp       , Gs^Fp       , Hh          , Hh          , Gg          , Gg          , Gg          , Gg^Vh       , Gg          , Rd          , Rd          , Ce          , Ce          , Ce          , Gg          , Gg          , Gg          , Gg          , Gg          , Gs^Fp       , Hh          , Hh          , Hh          , Gs^Fp       , Gs^Fp       
Gs^Fp       , Gs^Fp       , Hh          , Hh          , Hh          , Gg          , Gg          , Gg          , Rd          , Rd          , Hh          , Gg          , Ce          , Ke          , Ce          , Gg          , Gg          , Gg          , Gg^Vh       , Gg          , Gg          , Gs^Fp       , Hh          , Mm          , Gs^Fp       , Gs^Fp       
Hh          , Hh          , Hh          , Hh          , Hh          , Gg          , Gg          , Rd          , Gg          , Hh          , Gg          , Gg          , Gg          , Ce          , Gg          , Gg          , Gs^Fp       , Gg          , Gg          , Gg          , Hh          , Hh          , Mm          , Gs^Fp       , Hh          , Hh          
Gg          , Gg          , Gg          , Hh          , Gg          , Gg          , Gg          , Rd          , Gg          , Gg          , Gg          , Gg          , Gs^Fp       , Gg          , Gg          , Gg          , Gg          , Gs^Fp       , Gg          , Gg          , Gg          , Hh          , Hh          , Hh          , Gg          , Gg          
Gs^Fp       , Gs^Fp       , Gs^Fp       , Gg          , Gs^Fp       , Gg          , Gg          , Rd          , Gg          , Gg          , Gg          , Gs^Fp       , Gs^Fp       , Gs^Fp       , Gs^Fp       , Gs^Fp       , Gg          , Gs^Fp       , Gs^Fp       , Gg          , Gg          , Gg          , Gs^Fp       , Gg          , Gs^Fp       , Gs^Fp       
Gg          , Gg          , Gg          , Gs^Fp       , Gg          , Gg          , Rd          , Rd          , Rd          , Gg          , Rd          , Gg          , Gg          , Gg          , Gg          , Gs^Fp       , Gs^Fp       , Gg          , Gg          , Gg          , Gs^Fp       , Gs^Fp       , Gs^Fp       , Gs^Fp       , Gg          , Gg          
Gg          , Gg          , Gg^Vh       , Gg          , Rd          , Rd          , Gg          , Gg          , Gg          , Rd          , Gg          , Rd          , Rd          , Gg          , Gg          , Gs^Fp       , Gs^Fp       , Gs^Fp       , Gg          , Gg          , Gs^Fp       , Gs^Fp       , Gg^Vh       , Gs^Fp       , Gg          , Gg          
Gg          , Gg          , Rd          , Rd          , Gg          , Gg          , Gs^Fp       , Gg          , Gs^Fp       , Gg          , Gs^Fp       , Gg          , Gg          , Rd          , Rd          , Gg          , Gs^Fp       , Gg          , Gg          , Gg          , Gg          , Gs^Fp       , Gs^Fp       , Gs^Fp       , Gs^Fp       , Gs^Fp       
Rd          , Rd          , Gg          , Gg          , Gs^Fp       , Gs^Fp       , Gs^Fp       , Gs^Fp       , Ss          , Gs^Fp       , Gs^Fp       , Gs^Fp       , Gs^Fp       , Gg          , Gg          , Rd          , Gg          , Gg          , Ss          , Gg          , Gg          , Gs^Fp       , Gg          , Gs^Fp       , Gs^Fp       , Gs^Fp       
Rd          , Rd          , Rd          , Gg          , Gs^Fp       , Gs^Fp       , Ss          , Ss          , Gg          , Gg          , Gs^Fp       , Gs^Fp       , Gg          , Gg          , Gg          , Rd          , Ww^Bw\      , Ss          , Gs^Fp       , Ss          , Ss          , Gg          , Gg          , Hh          , Hh          , Hh          
Gg          , Gg          , Rd          , Gg          , Gs^Fp       , Ss          , Ss          , Gg          , Hh          , Gg          , Gg          , Gg          , Gg          , Gg          , Chs         , Ss          , Ss^Vhs      , Gg          , Gs^Fp       , Gg          , Gg          , Ss          , Gg          , Hh          , Mm          , Mm          
Gg          , Gg          , Rd          , Gg          , Gs^Fp       , Gg          , Gg          , Gg          , Hh          , Hh          , Hh          , Gg          , Gg          , Chw         , 2 Kh        , Ss          , Ss          , Gg          , Gg          , Gg^Vh       , Gs^Fp       , Ss          , Gg          , Hh          , Mm          , Mm          
Gg          , Gg          , Rd          , Gs^Fp       , Gs^Fp       , Gg          , Ss          , Gs^Fp       , Gs^Fp       , Hh          , Mm          , Hh          , Gg          , Chr         , Chr         , Chw         , Gg          , Ss          , Ss          , Gs^Fp       , Ss          , Ss          , Gg          , Hh          , Hh          , Hh          
Gg          , Gg          , Rd          , Gs^Fp       , Gs^Fp       , Gs^Fp       , Gg          , Gs^Fp       , Gs^Fp       , Hh          , Hh          , Hh          , Gg          , Chr         , Rr          , Rr          , Ww          , Ww          , Gg          , Ss          , Gg          , Gg          , Gs^Fp       , Hh          , Hh          , Hh          
Gs^Fp       , Gs^Fp       , Rd          , Gg          , Gs^Fp       , Gs^Fp       , Ss          , Ss          , Ss          , Gs^Fp       , Gs^Fp       , Hh          , Gg          , Chw         , Ss          , Rd          , Gg          , Re          , Hh          , Gg          , Gg          , Hh          , Hh          , Hh          , Gg          , Gg          
Gs^Fp       , Gs^Fp       , Gg          , Rd          , Gg          , Gg          , Ss          , Ss          , Ss          , Ss          , Re          , Re          , Re          , Ss          , Re          , Re          , Gg          , Hh          , Gg          , Hh          , Gg          , Gg          , Gg^Vh       , Gg          , Hh          , Hh          
Gs^Fp       , Gs^Fp       , Gs^Fp       , Rd          , Rd          , Gg          , Ww          , Ss          , Re          , Ww^Bw/      , Ss          , Ss          , Ww          , Re          , Qxu         , Gg          , Hh          , Hh          , Mm          , Gg          , Gg          , Gs^Fp       , Gs^Fp       , Gs^Fp       , Gg          , Gg          
Gs^Fp       , Gs^Fp       , Gg          , Rd          , Re          , Rd          , Gg          , Ss          , Re          , Ww          , Ww          , Ss          , Ss          , Gg          , Gg          , Qxu         , Qxu         , Hh          , Hh          , Mm          , Hh          , Hh          , Hh          , Gs^Fp       , Gs^Fp       , Gs^Fp       
Gg          , Gg          , Rd          , Rd          , Rd          , Rd          , Re          , Re          , Gs^Fp       , Ww          , Ss          , Ww          , Ww          , Gg          , Hh          , Hh          , Hh          , Qxu         , Qxu         , Hh          , Hh          , Mm          , Hh          , Gs^Fp       , Gs^Fp       , Gs^Fp       
Rd          , Rd          , Ce          , Ce          , Ce          , Re          , Gg          , Gs^Fp       , Gs^Fp       , Gg          , Ww          , Ww          , Re          , Gg          , Gg          , Gg          , Gs^Fp       , Hh          , Gs^Fp       , Gs^Fp       , Hh          , Hh          , Hh          , Hh^Vhh      , Gs^Fp       , Gs^Fp       
Gg          , Gg          , Ce          , 1 Ke        , Ce          , Re          , Gg          , Gg          , Gs^Fp       , Gg          , Gg          , Gg          , Gg          , Gs^Fp       , Gs^Fp       , Gs^Fp       , Gs^Fp       , Gs^Fp       , Gs^Fp       , Hh          , Mm          , Mm          , Hh          , Gg          , Gs^Fp       , Gs^Fp       
Gg          , Gg          , Gg          , Ce          , Re          , Re          , Gg          , Gg          , Gg          , Gs^Fp       , Gs^Fp       , Gs^Fp       , Gg          , Gs^Fp       , Gs^Fp       , Gs^Fp       , Hh          , Hh          , Hh          , Hh          , Hh          , Hh          , Gs^Fp       , Gg          , Gs^Fp       , Gs^Fp       
Gg          , Gg          , Gg          , Gg          , Re          , Gg          , Gg          , Gg          , Gg          , Gg          , Gg          , Gg          , Gg          , Gs^Fp       , Gs^Fp       , Gg          , Hh          , Mm          , Hh          , Gs^Fp       , Gs^Fp       , Gs^Fp       , Gs^Fp       , Gs^Fp       , Gg          , Gg          
Gg          , Gg          , Gg          , Gg          , Re          , Gg          , Gg          , Gg          , Gg          , Gg          , Gg          , Gg          , Gg          , Gs^Fp       , Gs^Fp       , Gg          , Hh          , Mm          , Hh          , Gs^Fp       , Gs^Fp       , Gs^Fp       , Gs^Fp       , Gs^Fp       , Gg          , Gg          
