border_size=1
usage=map

Gg          , Gg          , Gg          , Gg          , Gg          , Gg          , Gg          , Gs^Fp       , Gs^Fp       , Gs^Fp       , Hh          , Gs^Fp       , Hh          , Gg          , Gg          , Gs^Fp       , Gs^Fp       , Gs^Fp       , Gg          , Ww          , Gg          , Gs^Fp       , Gs^Fp       , Gg          , Gg          , Gg          , Hh          , Gs^Fp       , Ww          , Gg          , Ww          , Ww          
Gg          , Gg          , Gg          , Gg          , Gg          , Gg          , Gg          , Gs^Fp       , Gs^Fp       , Gs^Fp       , Hh          , Gs^Fp       , Hh          , Gg          , Gg          , Gs^Fp       , Gs^Fp       , Gs^Fp       , Gg          , Ww          , Gg          , Gs^Fp       , Gs^Fp       , Gg          , Gg          , Gg          , Hh          , Gs^Fp       , Ww          , Gg          , Ww          , Ww          
Gg          , Gg          , Ce          , Ce          , Ce          , Gg          , Gg          , Gg          , Gs^Fp       , Hh          , Mm          , Hh          , Hh          , Gg          , Gs^Fp       , Gs^Fp       , Ww          , Gs^Fp       , Ww          , Ww          , Gg          , Gs^Fp       , Gs^Fp       , Gg          , Gs^Fp       , Gs^Fp       , Gs^Fp       , Gs^Fp       , Ww          , Ww          , Gg          , Gg          
Gg          , Gg          , Ce          , 1 Ke        , Ce          , Gg          , Hh          , Gg^Vh       , Gg          , Hh          , Hh          , Mm          , Mm          , Hh          , Ww          , Ww          , Gg          , Ww          , Gg          , Gg          , Gg          , Gs^Fp       , Gg          , Gs^Fp       , Gg          , Gg          , Gs^Fp       , Gs^Fp       , Ww          , Gg          , Gg          , Gg          
Gg          , Gg          , Gg          , Ce          , Gg          , Gg          , Gg          , Hh          , Gg          , Gs^Fp       , Hh          , Hh          , Hh          , Hh          , Ww          , Ww          , Gg          , Gs^Fp       , Gs^Fp       , Gs^Fp       , Gs^Fp       , Gs^Fp       , Gg          , Gs^Fp       , Gg          , Gg^Vh       , Gs^Fp       , Ww          , Ww          , Gg          , Gg          , Gg          
Gg          , Gg          , Gg          , Gg          , Hh          , Gg          , Gg          , Hh          , Gg          , Gs^Fp       , Gs^Fp       , Gs^Fp       , Gs^Fp       , Gg          , Gg          , Ww          , Ww          , Gg          , Gg          , Gg          , Gg          , Gg          , Gg          , Gg          , Hh          , Gs^Fp       , Gg          , Ww          , Ww          , Gs^Fp       , Gs^Fp       , Gs^Fp       
Gg          , Gg          , Hh          , Gg          , Gg          , Hh          , Gg          , Gg          , Gg          , Gg          , Gg          , Gs^Fp       , Gg          , Gg          , Ww          , Ww          , Ww          , Gg          , Gg          , Gg          , Gg          , Gg^Vh       , Gg          , Gg          , Hh          , Gg          , Gs^Fp       , Ww          , Gs^Fp       , Gs^Fp       , Gg          , Gg          
Gg          , Gg          , Hh          , Gg          , Gg          , Hh          , Gg          , Gg          , Hh          , Hh          , Hh          , Hh          , Hh          , Ww          , Gs^Fp       , Gs^Fp       , Ww          , Gg          , Gg          , Gg          , Gg          , Rd          , Rd          , Gg          , Gg          , Hh          , Ww          , Ww          , Gg          , Gs^Fp       , Gg          , Gg          
Gg          , Gg          , Hh          , Gg          , Hh          , Gg          , Gg          , Gg          , Gg          , Gg          , Gg^Vh       , Gg          , Hh          , Ww          , Hh          , Ww          , Ww          , Hh          , Hh          , Gg          , Gs^Fp       , Gg          , Gg          , Rd          , Ww^Bw\      , Ww          , Gg          , Gg          , Re          , Re          , Gg          , Gg          
Gg          , Gg          , Gg          , Hh          , Rd          , Rd          , Rd          , Rd          , Rd          , Rd          , Rd          , Rd          , Rd          , Ww          , Gs^Fp       , Ww          , Gg          , Gg          , Hh          , Hh          , Hh          , Gg          , Gg          , Gg          , Ww          , Rd          , Rd          , Re          , Gg          , Gg          , Gg          , Gg          
Rd          , Rd          , Rd          , Rd          , Gg          , Hh          , Hh          , Hh          , Hh          , Hh          , Hh          , Hh          , Hh          , Ww^Bw\      , Ww^Bw\      , Ww          , Rd          , Gg^Vh       , Gg          , Gg          , Hh          , Gg          , Ww          , Gg          , Ww          , Gg          , Gg          , Rd          , Gg          , Gg          , Gg          , Gg          
Gg          , Gg          , Rd          , Gg          , Gs^Fp       , Gs^Fp       , Gs^Fp       , Gs^Fp       , Gs^Fp       , Gs^Fp       , Gs^Fp       , Hh          , Gs^Fp       , Ww          , Ww          , Rd          , Gg          , Rd          , Rd          , Hh          , Gs^Fp       , Ss          , Ss          , Ww          , Ww          , Gg          , Gg          , Rd          , Gg          , Gg          , Gg          , Gg          
Ww          , Ww          , Ww^Bw|      , Gg          , Gg          , Gg          , Hh          , Gg          , Gs^Fp       , Gg          , Gs^Fp       , Gg          , Ww          , Ww          , Gg          , Gg          , Hh          , Gg          , Hh          , Rr          , Rr          , Ss          , Ss          , Ww          , Gg          , Gg          , Gg          , Rd          , Gg          , Gg          , Gg          , Gg          
Gg          , Gg          , Ww^Bw|      , Ww          , Ww          , Gg          , Hh          , Hh          , Hh          , Gs^Fp       , Gg          , Gg          , Ww          , Ww          , Gg          , Hh          , Gs^Fp       , Hh          , Gs^Fp       , Re          , Rr          , Re          , Ww          , Ww          , Gg^Vh       , Gg          , Rr          , Rd          , Gg          , Gg          , Gg          , Gg          
Gg          , Gg          , Rd          , Ww          , Ww          , Gg          , Ss          , Gg          , Gs^Fp       , Ww          , Ww          , Ww          , Gg          , Gg          , Re          , Gg          , Gg          , Gs^Fp       , Gs^Fp       , Gg^Vh       , Ww          , Ww^Bw\      , Rr          , Chr         , Rr          , Rr          , 2 Kh        , Rr          , Rr          , Re          , Gg          , Gg          
Gg          , Gg          , Rd          , Gg^Vh       , Gg          , Ww          , Ss          , Gs^Fp       , Ww          , Ww          , Ww          , Gs^Fp       , Gs^Fp       , Gg          , Re          , Re          , Gg          , Gg          , Ww          , Ww          , Chr         , Chr         , Gg          , Rr          , Gg^Vh       , Chr         , Chr         , Chr         , Re          , Rr          , Rr          , Rr          
Gg          , Gg          , Rd          , Gg          , Gs^Fp       , Ss          , Gg          , Ww          , Gg          , Gg          , Gg          , Ww          , Ww          , Ww          , Ww          , Ww          , Ww          , Ww          , Gg          , Re          , Chr         , Gg          , Gg          , Re          , Chw         , Chr         , Ss          , Gg          , Gg          , Gg          , Gg          , Gg          
Gg          , Gg          , Rd          , Gs^Fp       , Gg          , Gs^Fp       , Hh          , Hh          , Hh          , Gs^Fp       , Gg          , Ww          , Ww          , Ww          , Gg          , Gg          , Gg          , Rd          , Gg          , Ss          , Ss          , Chr         , Ww          , Ww          , Ww          , Gg          , Gg          , Gg          , Gg          , Gs^Fp       , Gs^Fp       , Gs^Fp       
Gg          , Gg          , Gg          , Rd          , Rd          , Gs^Fp       , Hh          , Hh^Vhh      , Gs^Fp       , Hh          , Hh          , Gg          , Gg          , Ww          , Gg          , Gg          , Re          , Rr          , Re          , Gg          , Gg          , Ss          , Gg          , Ww          , Gg          , Gg          , Ww          , Ww          , Gs^Fp       , Gs^Fp       , Gg          , Gg          
Gg          , Gg          , Gs^Fp       , Gg          , Rd          , Gg          , Gg          , Gg          , Gs^Fp       , Gs^Fp       , Hh          , Gg          , Gg          , Ww          , Ww          , Gg          , Gg          , Gg          , Re          , Gg          , Gg          , Gg          , Gg          , Ww          , Ww          , Ww          , Ww          , Ww          , Gg          , Gg          , Gg          , Gg          
Gg          , Gg          , Gs^Fp       , Gg          , Gs^Fp       , Rd          , Rd          , Gg          , Gg          , Gs^Fp       , Gg          , Gg          , Gg          , Ww          , Ww          , Gg          , Gg          , Gg          , Re          , Gg          , Ww          , Ww          , Ww          , Ww          , Ww          , Ww          , Gg          , Gs^Fp       , Gg          , Gg          , Gg          , Gg          
Gg          , Gg          , Chr         , Chr         , Chr         , Gg          , Rd          , Gg          , Gg          , Gg          , Gg          , Gg          , Gg          , Gg          , Ww          , Ww          , Gg          , Gg          , Re          , Re          , Ww          , Gs^Fp       , Gs^Fp       , Ww          , Ww          , Ww          , Gg          , Gg          , Gs^Fp       , Gg          , Gg          , Gg          
Re          , Re          , Chr         , 3 Kh        , Chr         , Gg          , Rd          , Gg          , Gg          , Gg          , Gg          , Gg          , Gg          , Gg          , Gg          , Ww          , Gs^Fp       , Gg          , Re          , Ww          , Ww          , Gs^Fp       , Ww          , Ww          , Ww          , Ww          , Gg          , Gs^Fp       , Gs^Fp       , Gs^Fp       , Gs^Fp       , Gs^Fp       
Gg          , Gg          , Gg          , Chr         , Re          , Gg          , Rd          , Gg          , Gg          , Gg          , Gg          , Gg          , Gg          , Gg          , Ww          , Ww          , Gg          , Gg          , Gg          , Ww          , Ww          , Ww          , Gg^Vh       , Ww          , Gs^Fp       , Gs^Fp       , Gs^Fp       , Gg          , Hh          , Hh          , Gg          , Gg          
Gg          , Gg          , Rd          , Rd          , Rd          , Rd          , Rd          , Gg          , Gg          , Gg          , Gg          , Gg          , Hh          , Hh          , Ww          , Ww          , Gg          , Gg          , Ww          , Ww          , Gg          , Gs          , Gs          , Gg          , Gg          , Gg          , Hh          , Gg          , Hh          , Hh          , Hh          , Hh          
Rd          , Rd          , Gg^Vh       , Gg          , Gg          , Gg          , Rd          , Gg          , Gs^Fp       , Gg          , Gg          , Gg          , Gg          , Gg          , Ww          , Ww          , Ww          , Ww          , Gg          , Gg          , Gg          , Gs          , Gg          , Gs^Fp       , Hh          , Hh          , Hh          , Hh          , Mm          , Hh          , Hh          , Hh          
Rd          , Rd          , Gg          , Gg          , Gg          , Gg          , Rd          , Gg          , Gg          , Gs^Fp       , Gg          , Gs^Fp       , Gs^Fp       , Gg          , Gg          , Ww          , Ww          , Ss          , Gg          , Gg          , Gg          , Gs^Fp       , Gs^Fp       , Gg          , Hh          , Gs^Fp       , Hh          , Hh          , Mm          , Hh          , Hh          , Hh          
Rd          , Rd          , Gg          , Gg          , Gg          , Gg          , Rd          , Gg          , Gg          , Gs^Fp       , Hh          , Hh          , Hh          , Gg          , Gs^Fp       , Ss          , Ww          , Ss          , Gg          , Gg          , Gs^Fp       , Gs^Fp       , Gs^Fp       , Hh          , Hh          , Hh          , Hh          , Mm          , Mm          , Mm          , Mm          , Mm          
Gs^Fp       , Gs^Fp       , Hh          , Gg          , Hh          , Gg          , Gg          , Rd          , Rd          , Gg          , Hh          , Gs^Fp       , Hh          , Gs^Fp       , Gs^Fp       , Gs^Fp       , Gs^Fp       , Ww          , Gs^Fp       , Gg          , Gs^Fp       , Gs^Fp       , Gg          , Hh          , Hh          , Mm          , Hh          , Hh          , Hh          , Hh          , Mm          , Mm          
Hh          , Hh          , Hh          , Hh          , Hh          , Hh          , Hh          , Gg          , Rd          , Gs^Fp       , Gs^Fp       , Hh          , Gg          , Gs^Fp       , Gs^Fp       , Gs^Fp       , Gs^Fp       , Gs^Fp       , Gs^Fp       , Gs^Fp       , Gs^Fp       , Gs^Fp       , Gg          , Gg          , Hh          , Mm          , Hh          , Hh          , Mm          , Hh          , Mm          , Mm          
Gs^Fp       , Gs^Fp       , Gs^Fp       , Hh          , Hh          , Gg          , Rd          , Rd          , Gs          , Gg^Vh       , Gg          , Gs^Fp       , Gs^Fp       , Gs^Fp       , Gg          , Gs^Fp       , Gg          , Gs^Fp       , Gg          , Gs^Fp       , Gs^Fp       , Gs^Fp       , Gs^Fp       , Gs^Fp       , Gs^Fp       , Hh          , Gs^Fp       , Hh          , Hh          , Hh          , Mm          , Mm          
Gs^Fp       , Gs^Fp       , Gs^Fp       , Hh          , Hh          , Gg          , Rd          , Rd          , Gs          , Gg          , Gg          , Gs^Fp       , Gs^Fp       , Gs^Fp       , Gg          , Gs^Fp       , Gg          , Gs^Fp       , Gg          , Gs^Fp       , Gs^Fp       , Gs^Fp       , Gs^Fp       , Gs^Fp       , Gs^Fp       , Hh          , Gs^Fp       , Hh          , Hh          , Hh          , Mm          , Mm          
