Gs^Fp, Gs^Fp, Gg, Gs^Fp, Gs^Fp, Gs^Fp, Gg, Gs^Fp, Gs^Fp, Gg, Gg, Gg, Gs^Fp, Gs^Fp, Gs^Fp, Gg, Gg, Gg, Gg, Gg, Gg, Gg, Gs^Fp, Gg, Gs^Fp, Gg, Hh, Gs^Fp, Gs^Fp, Gs^Fp, Hh, Hh
Gs^Fp, Gs^Fp, Gg, Gs^Fp, Gs^Fp, Gs^Fp, Gg, Gs^Fp, Gs^Fp, Gg, Gg, Gg, Gs^Fp, Gs^Fp, Gs^Fp, Gg, Gg, Gg, Gg, Gg, Gg, Gg, Gs^Fp, Gg, Gs^Fp, Gg, Hh, Gs^Fp, Gs^Fp, Gs^Fp, Hh, Hh
Gg, Gg, Ce, Ce, Ce, Gg, Gs^Fp, Gs^Fp, Gg, Gs^Fp, Gg, Gs^Fp, Gg, Gs^Fp, Gs^Fp, Gg, Gg, Gg, Gs^Fp, Gs^Fp, Gs^Fp, Gs^Fp, Gg, Gs^Fp, Gs^Fp, Gg, Hh, Gs^Fp, Hh, Hh, Mm, Mm
Gg, Gg, Ce, 1 Ke, Ce, Gg, Gs^Fp, Gg^Vh, Gs^Fp, Gg, Gg, Gs^Fp, Gg, Gs^Fp, Gg, Gg, Gg, Gg, Gg, Gg, Gs^Fp, Gg, Gg, Gg, Gs^Fp, Gg, Hh, Hh, Mm, Hh, Mm, Mm
Gg, Gg, Gg, Ce, Gg, Gg, Gg, Gg, Gg, Gs^Fp, Gg, Gs^Fp, Gs^Fp, Gs^Fp, Gg, Gg, Gs^Fp, Gg, Gs^Fp, Gs^Fp, Gs^Fp, Gs^Fp, Gs^Fp, Gs^Fp, Gs^Fp, Gg, Hh, Mm, Mm, Hh, Hh, Hh
Gs^Fp, Gs^Fp, Gs^Fp, Gg, Gs^Fp, Gs^Fp, Gg, Gg, Gg, Gs^Fp, Gg, Gg, Gg, Gs^Fp, Gs^Fp, Gg, Gs^Fp, Gs^Fp, Gs^Fp, Gs^Fp, Gg, Gg, Gs^Fp, Gs^Fp, Hh, Hh, Gg, Mm, Mm, Gs^Fp, Gs^Fp, Gs^Fp
Gs^Fp, Gs^Fp, Gs^Fp, Gg, Gs^Fp, Gg, Gs^Fp, Gs^Fp, Gs^Fp, Gg, Gg, Gg, Gg, Gg, Gs^Fp, Gs^Fp, Gg, Gs^Fp, Gg, Gg, Gs^Fp, Gs^Fp, Gg, Gs^Fp, Hh, Gg, Hh, Hh, Gs^Fp, Gs^Fp, Gg, Gg
Gs^Fp, Gs^Fp, Gg, Gg, Gg, Gg, Gs^Fp, Gs^Fp, Gs, Gs, Gg, Gs^Fp, Gs^Fp, Gs^Fp, Gg, Gg, Gg, Gg, Gs^Fp, Gs^Fp, Gg, Gg, Gg, Gs^Fp, Gs^Fp, Hh, Gg, Gs^Fp, Gg, Gg, Gg, Gg
Gg, Gg, Gg, Gg, Gs^Fp, Gg, Gg, Gg, Gg, Gg, Gg^Vh, Gg, Gg, Gs^Fp, Gs^Fp, Gs^Fp, Gs^Fp, Gs^Fp, Gg, Gg, Gs^Fp, Gg, Gg, Gg, Gg, Gg, Gg, Gg, Re, Re, Gg, Gg
Gg, Gg, Gs^Fp, Gs^Fp, Gg, Gs^Fp, Re, Re, Re, Re, Re, Re, Rd, Gg, Gg, Gs^Fp, Gg, Gg, Gs, Gg, Gg, Gg, Gg, Gg, Gg, Gg, Gg, Re, Gg, Gg, Gg, Gg
Gg, Gg, Gg, Gg, Gg, Gg, Gg, Gg, Gg, Gg, Gs^Fp, Gg, Gg, Rd, Rd, Gg, Rd, Gg^Vh, Gg, Gg, Re, Gg, Gg, Gg, Gg, Gg, Gg, Gg, Gg, Gg, Gg, Gg
Gg, Gg, Gg, Gg, Gs^Fp, Gs^Fp, Gs^Fp, Gs^Fp, Gs^Fp, Gs^Fp, Gs^Fp, Gg, Gs^Fp, Gg, Gg, Rd, Gg, Rd, Rd, Re, Chr, Re, Chr, Chr, Chr, Chr, Chr, Gg, Gg, Gg, Gg, Gg
Ww, Ww, Ww, Gg, Gg, Gg, Gg, Gg, Gs^Fp, Gg, Gs^Fp, Gg, Gg, Gg, Gg, Gg, Re, Gg, Chr, Rr, Rr, Re, Gg, Gg, Chr, 2 Kh, Chr, Gg, Gg, Gs, Gs, Gs
Gg, Gg, Ww, Ww, Ww, Gg, Gs^Fp, Gs^Fp, Gs^Fp, Gs^Fp, Gg, Gg, Gg, Gg, Gg, Gg, Ss, Re, Chr, Re, Rr, Re, Gg^Vh, Re, Gg^Vh, Chr, Rr, Re, Gg, Gs, Gg, Gg
Gg, Gg, Gg, Ww, Ww, Gg, Gg, Gg, Gs^Fp, Gg, Gs^Fp, Gg, Gg, Gg, Re, Gg, Gg, Gg, Chr, Gg^Vh, Rr, Rr, Rr, Rr, Rr, Rr, Re, Rr, Rr, Re, Gg^Vh, Gg
Gg, Gg, Gg, Gg^Vh, Gs^Fp, Gg, Gs^Fp, Gs^Fp, Gg, Gs^Fp, Gs^Fp, Gs^Fp, Gs^Fp, Gg, Re, Re, Gg, Gg, Rr, Rr, Chr, Re, Gg, Rr, Gg^Vh, Chr, Ss, Re, Re, Rr, Rr, Rr
Gg, Gg, Gg, Gs^Fp, Gs^Fp, Gs^Fp, Gs^Fp, Gs^Fp, Gs^Fp, Gs^Fp, Gs^Fp, Gs^Fp, Gs^Fp, Gg, Gg, Re, Gg, Rd, Gg, Re, Re, Chr, Gg, Re, Chw, Chr, Ss, Gg, Gg, Gg, Gg, Gg
Gg, Gg, Gs^Fp, Gs^Fp, Gg, Gs^Fp, Gg, Gs^Fp, Gs^Fp, Gs^Fp, Gs^Fp, Gs^Fp, Gs^Fp, Gg, Gg, Gg, Gg, Rd, Gg, Ss, Ss, Re, Ww, Ww, Ww, Gg, Gg, Gg, Gg, Gg, Ww, Ww
Gg, Gg, Gg, Gs^Fp, Gs^Fp, Gs^Fp, Gs^Fp, Gs^Fp, Gs^Fp, Gs^Fp, Gs^Fp, Gs^Fp, Gs^Fp, Gg, Gg, Gg, Re, Rr, Re, Gg, Gg, Ss, Gg, Ww, Gg, Gg, Ww, Ww, Wwf, Wwf, Gg, Gg
Gg, Gg, Gs^Fp, Gg, Gg, Gs^Fp, Gg, Gg, Gs^Fp, Gs^Fp, Gs^Fp, Gg, Gg, Gg, Gg, Gg, Rd, Rd, Re, Gg, Gg, Gg, Gg, Ss, Ss, Wwf, Gg, Gg, Gg, Gg, Gg, Gg
Gg, Gg, Gs^Fp, Gs^Fp, Gs^Fp, Gg, Gg, Gg, Gg, Gs^Fp, Gg, Gg, Rr, Gg^Vh, Rr, Rd, Gg, Re, Re, Gg, Gg, Gg, Ss, Ss, Ss, Gg, Gg, Gg, Gg, Gg, Gg, Gg
Gg, Gg, Gg, Gs^Fp, Gg, Gg, Gg, Gg, Gg, Gg, Rd, Rr, Re, Rr, Gg, Gg, Gg, Gg, Re, Re, Ss, Gg, Ss, Gg, Ss, Gg, Gg, Gg, Gs^Fp, Gg, Gg, Gg
Re, Re, Re, Gg, Re, Gg, Gg, Gg, Rr, Rd, Gg, Gg, Gg, Gg, Gg, Gs^Fp, Gs^Fp, Gg, Re, Ss, Gg, Wwf, Gg, Ss, Gg, Gg, Gg, Gs^Fp, Gs^Fp, Gs^Fp, Gs^Fp, Gs^Fp
Gg, Gg, Gg, Gg, Re, Gg, Re, Re, Rr, Gg^Vh, Gs, Gs, Gg, Gg, Gg, Gs^Fp, Gg, Gg, Gg, Ww, Gg, Gg, Gg^Vh, Gg, Gs^Fp, Gs^Fp, Gs^Fp, Gg, Gg, Gg, Gg, Gg
Gg, Gg, Re, Gg, Chr, Re, Rr, Rr, Gg, Gg, Gs, Gg, Hh, Hh, Gg, Gg, Gg, Gg, Wwf, Wwf, Gg, Gs, Gs, Gg, Gg, Gg, Gs^Fp, Gg, Gs^Fp, Gg, Gg, Gg
Re, Re, Gg, Chr, 3 Kh, Chr, Rd, Gg, Gs^Fp, Gg, Gg, Gg, Gg, Gg, Gg, Gg, Ss, Ww, Gg, Gg, Gg, Gs, Gg, Gs^Fp, Gs^Fp, Gs^Fp, Gs^Fp, Gs^Fp, Gg, Gs^Fp, Gg, Gg
Re, Re, Gg, Chr, Chr, Chr, Rd, Gg, Gg, Gs^Fp, Gg, Gs^Fp, Gs^Fp, Gg, Gg, Wwf, Ww, Ss, Gg, Gg, Gg, Gs^Fp, Gs^Fp, Gg, Gg, Gs^Fp, Gs^Fp, Gg, Gs^Fp, Gs^Fp, Gg^Vh, Gg
Re, Re, Gg, Gg, Gg, Gg^Vh, Rd, Gg, Gg, Gs^Fp, Gs^Fp, Gs^Fp, Gs^Fp, Gg, Gg, Ss, Ww, Ss, Gg, Gg, Gg, Gs^Fp, Gs^Fp, Gs^Fp, Gs^Fp, Gg, Gg, Gs^Fp, Gg, Gg, Gg, Gg
Gs^Fp, Gs^Fp, Gs^Fp, Gg, Gg, Gg, Gg, Rd, Rd, Gg, Gg, Gg, Gg, Gs^Fp, Gg, Ss, Ss, Ww, Wwf, Gg, Ss, Gg, Gg, Gs^Fp, Gs^Fp, Gg, Gs^Fp, Gg, Gg, Gs^Fp, Gg, Gg
Gs^Fp, Gs^Fp, Gs^Fp, Gs^Fp, Gg, Gg, Gg, Gg, Rd, Rd, Rd, Gg, Gg, Gs^Fp, Gg, Gg, Gg, Gg, Ss, Ss, Ss, Ss, Gg, Gg, Gs^Fp, Gs^Fp, Gs^Fp, Gs^Fp, Gs^Fp, Gs^Fp, Gs^Fp, Gs^Fp
Gs^Fp, Gs^Fp, Gs^Fp, Gg, Gg, Gg, Rd, Rd, Gs, Gg^Vh, Gg, Rd, Rd, Gg, Gg, Gg, Gg, Gg, Gg, Ss, Gg, Ww, Wwf, Gg, Gg, Gs^Fp, Gs^Fp, Gs^Fp, Gg, Gg, Gg, Gg
Gs^Fp, Gs^Fp, Gs^Fp, Gg, Gg, Gg, Rd, Rd, Gs, Gg, Gg, Rd, Rd, Gg, Gg, Gg, Gg, Gg, Gg, Ss, Gg, Ww, Wwf, Gg, Gg, Gs^Fp, Gs^Fp, Gs^Fp, Gg, Gg, Gg, Gg
