Hh, Hh, Hh, Mm, Hh, Mm, Hh, Hh, Gg, Gg, Hh, Gg, Gg, Gg, Gg, Hh, Gs^Fp, Gs^Fp, Ww, Ww, Gg, Gg, Gg, Gg, Gs^Fp, Gs^Fp, Gg, Gg, Gs^Fp, Ss, Ss, Gg, Gs^Fp, Gg, Gs^Fp, Gg, Gs^Fp, Gg, Gg, Ss, Gg, Gg, Re, Gg, Gg, Gg, Gg
Hh, Hh, Hh, Mm, Hh, Mm, Hh, Hh, Gg, Gg, Hh, Gg, Gg, Gg^Vh, Gg, Hh, Gs^Fp, Gs^Fp, Ww, Ww, Gg, Gg, Gg, Gg, Gs^Fp, Gs^Fp, Gg, Gg, Gs^Fp, Ss, Ss, Gg, Gs^Fp, Gg, Gs^Fp, Gg, Gs^Fp, Gg, Gg, Ss, Gg, Gg, Re, Gg, Gg, Gg, Gg
Hh, Hh, Mm, Hh, Hh, Hh, Gg, Gg, Hh, Hh, Gg, Hh, Hh, Gg, Gg, Hh, Gg, Gg, Re, Ww, Ww, Gg, Gg, Gg, Gs^Fp, Gs^Fp, Gs^Fp, Gs^Fp, Ss, Gs^Fp, Gs^Fp, Gs^Fp, Gs^Fp, Gs^Fp, Gs^Fp, Gs^Fp, Gg, Gs^Fp, Ss, Ss, Gg, Re, Ce, Ce, Ce, Gg, Gg
Hh, Hh, Hh, Mm, Mm, Hh, Hh, Gg^Vh, Gg, Gg, Hh, Gg, Hh^Vhh, Hh, Gg, Hh, Gg, Gg, Gg, Re, Ce, Ww, Ww, Gg, Gg, Gg, Gs^Fp, Gs^Fp, Gs^Fp, Gs^Fp, Gg, Gs^Fp, Gs^Fp, Gs^Fp, Ss, Gg, Gg, Gg, Gg, Re, Re, Re, Ce, 9 Ke, Ce, Gg, Gg
Hh, Hh, Hh, Mm, Hh, Mm, Hh, Hh, Mm, Gg, Hh, Hh, Hh, Hh, Gg, Gg, Ch, Ch, Ch, Gg, Gg^Vh, Ce, Re, Ww, Ww, Gg, Gg, Gg, Gg, Gg, Gg, Gg, Gs^Fp, Gg, Ss, Gg, Ss, Gg, Gg, Re, Gs^Fp, Re, Re, Ce, Re, Re, Re
Gs^Fp, Gs^Fp, Gs^Fp, Hh, Gs^Fp, Hh, Gs^Fp, Gs^Fp, Gs^Fp, Hh, Gs^Fp, Gs^Fp, Gs^Fp, Gs^Fp, Gs^Fp, Gg, Ch, 3 Kh, Ch, Re, Re, Re, Re, Ce, Ce, Ww, Gg, Gg, Gs^Fp, Gg, Gs^Fp, Gs^Fp, Gg, Ss, Gs^Fp, Gs^Fp, Gs^Fp, Ss, Gs^Fp, Gs^Fp, Gs^Fp, Gs^Fp, Gs^Fp, Re, Re, Re, Re
Ww, Ww, Ww, Gs^Fp, Gs^Fp, Gs^Fp, Ww, Gs^Fp, Ww, Gs^Fp, Ww, Gs^Fp, Ww, Gs^Fp, Ww, Gg, Gg, Ch, Gg, Gg, Re, Gg^Vh, Re, Re, Ce, Ww, Ww, Gg, Gs^Fp, Gg, Gs^Fp, Gs^Fp, Gs^Fp, Gs^Fp, Gs^Fp, Gs^Fp, Gs^Fp, Gs^Fp, Gs^Fp, Gg, Re, Gs^Fp, Re, Re, Gg, Gs, Gs
Gs^Fp, Gs^Fp, Gs^Fp, Ww, Ww, Ww, Ww, Ww, Gg, Ww, Gs^Fp, Ww, Gs^Fp, Ww, Gs^Fp, Ww, Ww, Gg, Gg, Re, Ce, Gg, Gg^Vh, Re, Re, Ww, Gg^Vh, Gg, Gs^Fp, Gg^Vh, Gs^Fp, Gg, Gs^Fp, Gg, Gs^Fp, Gs^Fp, Re, Gs^Fp, Re, Re, Re, Re, Ss, Ss, Ss, Gs, Gg
Hh, Hh, Hh, Gs^Fp, Gs^Fp, Gg^Vh, Gg, Gs^Fp, Gs^Fp, Gs^Fp, Hh, Gs^Fp, Gs^Fp, Gs^Fp, Hh, Gg, Gg, Ww, Ww^Bw/, Re, Gg, Ce, Ce, Re, Gg, Ww^Bw\, Re, Re, Re, Gs^Fp, Re, Re, Re, Re, Re, Re, Gg, Re, Ss, Gg, Ss, Ss, Ss, Ss, Gg, Ss, Ss
Hh, Hh, Hh, Hh, Hh, Gg, Gs^Fp, Hh, Hh, Hh, Hh^Vhh, Hh, Hh, Hh, Hh, Hh, Gs^Fp, Rd, Gg, Ww, Ww, Gg, Ww, Gg, Ww, Ww, Gg, Gs^Fp, Gg, Re, Ss, Re, Re, Ss, Ss, Ss, Ss, Ss, Ss, Ss, Re, Ss, Rb, Gs, Gd, Gg, Gg
Hh, Hh, Gs^Fp, Hh, Gg, Gg, Gg, Hh, Ce, Hh, Hh, Hh, Gg, Gg, Rd, Gg^Vh, Rd, Rd, Gg, Gs^Fp, Gs^Fp, Ww, Gs^Fp, Ww, Ww, Gg, Gs^Fp, Gs^Fp, Gg, Ss, Ss, Ss, Gg, Re, Re, Ss, Gg, Ss, Ss, Ss, Re, Gs, Rb, Re, Gs, Gs, Gs
Gs^Fp, Gs^Fp, Gs^Fp, Gg, Gg, Gg, Gg, Ce, 4 Ke, Ce, Gg, Gg, Rd, Rd, Gs^Fp, Rd, Gs^Fp, Gg, Gg, Gs^Fp, Gs^Fp, Gs^Fp, Gs^Fp, Gs^Fp, Ww, Gs^Fp, Gs^Fp, Gs^Fp, Gg, Ss, Gg, Gg, Gg, Gg, Gg, Re, Re, Gs, Gd, Rb, Re, Gd^Vhr, Re, Gd, Gg, Gg, Gg
Gs^Fp, Gs^Fp, Gs^Fp, Gs^Fp, Gg, Gs^Fp, Gg, Ce, Ce, Ce, Rd, Rd, Re, Rd, Re, Gg, Gs^Fp, Gs^Fp, Gs^Fp, Gg, Gg, Gg, Gg, Gs^Fp, Ww, Gg, Gs^Fp, Gs^Fp, Gg, Gg, Gg, Gg, Gg, Gg, Ww, Gg, Gs^Fp, Re, Re, Re, Re, Re, Gd, Re, Re, Gd^Vhr, Gg
Gs^Fp, Gs^Fp, Gg, Gg, Gg, Gg, Gg^Vh, Gg, Rd, Rd, Ce, Re, Ce, Ce, Ce, Re, Gg, Gs^Fp, Gg, Gg, Re, Gg^Vh, Gg, Gs^Fp, Gs^Fp, Ww, Gs^Fp, Gg^Vh, Gg, Gg, Gg, Gg, Gg, Gg, Ww, Ww, Gs^Fp, Gd, Rb, Rb, Ce, Ce, Ce, Gg, Gd, Re, Re
Hh, Hh, Hh, Gg, Gg, Re, Re, Rd, Gg, Ce, Gg, Re, Re, Gg, Ce, Re, Re, Gg^Vh, Gg, Gg, Gg, Gg, Gg, Gs^Fp, Gg^Vh, Ww, Gs^Fp, Gs^Fp, Gg, Gg, Gg, Gg, Gg, Gg, Ww, Ww, Gs^Fp, Gs, Gd^Vhr, Rb, Ce, 8 Ke, Ce, Gs, Re, Gg, Gs
Mm, Mm, Mm, Hh, Hh, Gg, Gs^Fp, Rd, Gs^Fp, Gg, Gg, Gg, Gg, Gg, Gg, Ce, Ce, Re, Gg, Gg^Vh, Gg, Re, Re, Gg, Ww, Ww, Gs^Fp, Gs^Fp, Gg, Gg, Gg, Gg, Ww, Ww, Wo, Ww, Gg, Gs^Fp, Gs^Fp, Gs, Re, Ce, Gd, Re, Re^Es, Re, Re
Hh, Hh, Hh, Mm, Hh, Hh, Gg, Rd, Gs^Fp, Gs^Fp, Gs^Fp, Gg, Gg, Gs^Fp, Re, Gg, Re, Re, Re, Gg, Gg, Re, Ce, Ce, Ce, Ww, Gg, Gg, Gg, Gg, Gg, Ww, Wo, Wo, Ww, Ww, Gs^Fp, Gs^Fp, Gg, Gs^Fp, Gg, Gs, Rb, Re, Gd, Gs, Gg
Gg, Gg, Gs^Fp, Hh, Hh, Hh, Gg, Rd, Gg^Vh, Gs^Fp, Gg, Gs^Fp, Gg, Re, Gg, Gg, Re, Gg, Gg, Re, Re, Re, Ce, 5 Ke, Ce, Ww, Gg, Gg, Gg^Vh, Gg, Ww, Ww, Wo, Ww, Gg, Gg, Gs^Fp, Gs^Fp, Gs^Fp, Gs^Fp, Gs^Fp, Gd, Gs, Gd^Vhr, Gg, Gd, Gg
Ww, Ww, Ww, Ww, Ww, Ww, Ww, Ww^Bw|, Ww, Ww, Ww, Gg, Ww, Gg, Ww, Gg^Vh, Re, Gg, Gg, Gg^Vh, Gg, Gg, Gg, Ce, Ww, Ww, Gg, Gg, Gg, Gg, Gg, Ww, Ww, Ww, Gg, Gg, Gg, Gs^Fp, Gg, Gg, Ss, Gs, Ss, Ss, Gs^Fp, Gs, Gs
Ww, Ww, Gg^Vh, Gg, Gs^Fp, Gs^Fp, Gg, Rd, Gg, Gg, Gg, Ww, Gg, Ww, Gg, Ww, Ww^Bw|, Ww, Ww, Gg, Ww, Gg, Ww, Ww, Gg, Ce, Ce, Gg, Ce, Ce, Ce, Gg, Gg, Gg, Gg, Gg, Ss, Gg, Ss, Ss, Gg, Ss, Gs^Fp, Gs^Fp, Gd, Gg, Gs
Gg, Gg, Gg, Gg, Gg, Gs^Fp, Gg, Rd, Gg, Hh, Gg, Gg, Gg, Gg, Gs^Fp, Gg, Re, Gg, Gg, Ww, Gg, Ww, Ww, Gg, Gg, Re, Gg, Gg, Ce, 6 Ke, Ce, Gg, Gg, Gg, Ss, Ss, Ss, Gg, Ss, Ss, Gg, Gs^Fp, Gs^Fp, Gg, Gs^Fp, Gs^Es, Gg
Gg, Gg, Hh, Hh, Hh, Gg, Rd, Rd, Gs^Fp, Gs^Fp, Gg, Gs^Fp, Gs^Fp, Gs^Fp, Re, Re, Hh, Hh, Hh^Vhh, Hh, Hh, Ww, Ww, Ww, Ww, Gg, Gg^Vh, Gg, Gg, Ce, Gg, Gg, Ce, Gg, Gg, Ss, Gg, Ss, Gg, Gg, Gs^Fp, Gs^Fp, Rd, Gd^Vhr, Rd, Rd, Rd
Hh, Hh, Hh, Mm, Hh, Hh, Rd, Gg, Gs^Fp, Gs^Fp, Gg, Gg, Gg, Gg, Re, Gg, Gg, Gg, Gg, Gg, Hh, Gg, Gg, Ww, Ww, Ww, Ww, Ww, Ww, Gg, Ww, Gg, Gg, Ce, Ce, Gg, Gg, Gg, Gg, Gg, Rd, Rd, Gs^Fp, Rd, Gd, Gs, Gg
Gg, Gg, Gg, Hh, Gg, Gg, Rd, Gg, Hh, Hh, Hh, Gg, Gs^Fp, Gs^Fp, Gg, Re, Re, Gg, Gg, Gg, Gg, Gg, Gs^Fp, Gg, Gg, Ww, Ww, Ww, Ww, Ww, Ww, Ww, Ww, Ww, Ww, Ce, Gg, Gg, Rd, Rd, Gg, Gs, Ce, Ce, Ce, Gd, Gg
Gg, Gg, Gg, Gg, Gg, Gg^Vh, Rd, Gg, Hh, Hh, Mm, Hh, Gg, Gs^Fp, Gg, Gg, Gs^Fp, Re, Re, Gg, Rd, Gg^Vh, Gg, Gs^Fp, Gs^Fp, Gs^Fp, Gg, Gg, Hh, Ww, Gs^Fp, Ww, Ww, Ww, Ww, Ww, Ww^Bw/, Rd, Gg, Gg, Gg, Gs, Ce, 7 Ke, Ce, Gs, Gg
Gg, Gg, Gg, Gg, Ce, Gg, Rd, Gg, Gg, Hh, Hh, Hh, Gg, Gs^Fp, Gg, Gg, Gs^Fp, Gg, Rd, Rd, Gg, Rd, Rd, Gg, Rd, Gs^Fp, Gg^Vh, Gg, Gg, Hh, Hh, Gg, Gs^Fp, Gs^Fp, Rd, Ww^Bw/, Ww, Gg^Vh, Gg, Gg, Gg, Gs, Gs, Ce, Gd, Gd, Gs
Gg, Gg, Gg, Ce, 2 Ke, Ce, Gg^Vh, Rd, Gg, Gg, Gg, Hh, Gg, Gs^Fp, Gg, Gs^Fp, Gs^Fp, Gg, Rd, Gg, Ce, Gg, Gg, Rd, Gg, Rd, Rd, Rd, Rd, Rd, Rd, Gs^Fp, Rd, Rd, Ww, Ww, Ww, Gg, Gg, Gg, Gg, Gs, Gd^Vhr, Gs, Gd, Rb, Gg
Gg, Gg, Gg, Ce, Ce, Ce, Gg, Rd, Rd, Gg, Gg, Hh, Gg, Gs^Fp, Gg, Gs^Fp, Rd, Rd, Gg, Ce, 1 Ke, Ce, Gg, Gg, Gg, Gg, Gs^Fp, Gg, Gg, Gg^Vh, Hh, Rd, Gg^Vh, Ww, Ww, Ww, Gg, Gg, Gg, Gg, Gg, Gs, Gs, Gd, Gs, Gs, Gs
Gg, Gg, Gg, Gg, Gg, Gg, Gg, Gg, Gg^Vh, Rd, Rd, Gg, Gg, Gs^Fp, Rd, Rd, Re, Re, Gg, Ce, Ce, Ce, Gg, Gg, Gg, Gg^Vh, Gg, Gs^Fp, Gg, Hh, Gg, Gg, Ww, Ww, Ww, Gg, Gg, Gg, Gg, Gg, Gs^Fp, Gs^Fp, Gd, Gs^Fp, Gs^Fp, Gs^Fp, Gs^Fp
Gg, Gg, Gs^Fp, Gs^Fp, Gs^Fp, Gg, Gs^Fp, Gs^Fp, Gs^Fp, Gg, Gs^Fp, Rd, Rd, Rd, Gg, Gg, Gg, Gg, Gg, Gg, Gg, Gg, Gg, Gg, Gg, Gg, Gg, Gs^Fp, Gs^Fp, Hh, Gs^Fp, Gs^Fp, Ww, Ww, Gs^Fp, Gg, Gg, Gg, Gs^Fp, Gs^Fp, Gg, Gs^Fp, Gs^Fp, Gs^Fp, Gd^Vhr, Gs^Fp, Gs^Fp
Gs^Fp, Gs^Fp, Gg, Gs^Fp, Gg, Gs^Fp, Gg, Gs^Fp, Gg, Gs^Fp, Gg, Gs^Fp, Gs^Fp, Rd, Gg, Gs^Fp, Gs^Fp, Gs^Fp, Gs^Fp, Gs^Fp, Gs^Fp, Gs^Fp, Gs^Fp, Gs^Fp, Gs^Fp, Gs^Fp, Gs^Fp, Gs^Fp, Gs^Fp, Gs^Fp, Gs^Fp, Gs^Fp, Ww, Ww, Gg, Gs^Fp, Gs^Fp, Gs^Fp, Gs^Fp, Gs^Fp, Gs^Fp, Gs^Fp, Gg, Gs^Fp, Gs^Fp, Gs^Fp, Gs^Fp
Gs^Fp, Gs^Fp, Gg, Gs^Fp, Gg, Gs^Fp, Gg, Gs^Fp, Gg, Gs^Fp, Gg, Gs^Fp, Gs^Fp, Rd, Gg, Gs^Fp, Gs^Fp, Gs^Fp, Gs^Fp, Gs^Fp, Gs^Fp, Gs^Fp, Gs^Fp, Gs^Fp, Gs^Fp, Gs^Fp, Gs^Fp, Gs^Fp, Gs^Fp, Gs^Fp, Gs^Fp, Gs^Fp, Ww, Ww, Gg, Gs^Fp, Gs^Fp, Gs^Fp, Gs^Fp, Gs^Fp, Gs^Fp, Gs^Fp, Gg, Gs^Fp, Gs^Fp, Gs^Fp, Gs^Fp
