Gs^Fp, Gs^Fp, Gs^Fp, Gs^Fp, Gs^Fp, Gs^Fp, Gg, Gg, Gs^Fp, Gs^Fp, Gg, Gs^Fp, Gs^Fp, Gs^Fp, Gg, Gg, Gg, Gg, Gs^Fp, Gs^Fp, Gs^Fp, Gs^Fp, Gs^Fp, Gg, Gs^Fp, Gs^Fp, Gs^Fp, Gg, Gs^Fp, Gg, Gg, Gg
Gs^Fp, Gs^Fp, Gs^Fp, Gs^Fp, Gs^Fp, Gs^Fp, Gg, Gg, Gs^Fp, Gs^Fp, Gg, Gs^Fp, Gs^Fp, Gs^Fp, Gg, Gg, Gg, Gg, Gs^Fp, Gs^Fp, Gs^Fp, Gs^Fp, Gs^Fp, Gg, Gs^Fp, Gs^Fp, Gs^Fp, Gg, Gs^Fp, Gg, Gg, Gg
Gs^Fp, Gs^Fp, Gs^Fp, Gg, Gs^Fp, Gs^Fp, Gg, Gs^Fp, Gs^Fp, Gs^Fp, Gs^Fp, Gg, Gs^Fp, Gg, Gg, Gg^Efm, Gg, Gg, Gg, Gg, Hh, Hh, Gg, Gs^Fp, Gs^Fp, Gg, Gg, Gg, Gg, Gs^Fp, Gs^Fp, Gs^Fp
Gs^Fp, Gs^Fp, Gg, Gs^Fp, Gs^Fp, Gs^Fp, Ce, Gs^Fp, Gs^Fp, Gs^Fp, Gs^Fp, Gs^Fp, Gs^Fp, Gg, Gs^Fp, Gg, Gg, Hh, Hh, Hh, Hh, Gg, Hh, Gg, Gg, Gs^Fp, Ce, Ce, Ce, Gs^Fp, Gg, Gg
Gs^Fp, Gs^Fp, Gs^Fp, Gg, Gs^Fp, Ce, 1 Ke, Ce, Gs^Fp, Gs^Fp, Gs^Fp, Gg, Gg^Vh, Gs^Fp, Gs^Fp, Gg, Gs^Fp, Gg, Gg, Gg, Gg, Hh, Gg, Gg, Gg, Gg, Ce, 3 Ke, Ce, Gs^Fp, Gs^Fp, Gs^Fp
Gg, Gg, Gs^Fp, Gs^Fp, Gg, Ce, Ce, Ce, Gg, Gs^Fp, Gg, Gs^Fp, Gs^Fp, Gs^Fp, Gs^Fp, Gs^Fp, Gs^Fp, Gg, Gs^Fp, Gs^Fp, Gg, Gg, Gg, Gs^Fp, Gs^Fp, Re, Gg, Ce, Gg, Gg, Gs^Fp, Gs^Fp
Gg, Gg, Gs^Fp, Gg, Gg, Gs^Fp, Gg, Gs^Fp, Gg, Gs^Fp, Gs^Fp, Gs^Fp, Gs^Fp, Gs^Fp, Gg, Gg, Gg, Gg, Gg, Gs^Fp, Gs^Fp, Gg^Vh, Gs^Fp, Gs^Fp, Gs^Fp, Re, Re, Re, Re, Re, Gs^Fp, Gs^Fp
Gg, Gg, Gs^Fp, Gg^Vh, Gs^Fp, Gs^Fp, Gs^Fp, Gs^Fp, Gs^Fp, Gg, Gs^Fp, Gg, Gg, Gs^Fp, Gs^Fp, Gg, Gg, Gs^Fp, Gg, Gs^Fp, Gg, Gg, Gs^Fp, Gs^Fp, Gg^Vh, Gs^Fp, Gs^Fp, Re, Re, Gs^Fp, Gg, Gg
Gs^Fp, Gs^Fp, Gs^Fp, Gs^Fp, Gs^Fp, Gg, Gg, Gg, Gs^Fp, Gg, Gg, Gg, Gg, Gg, Gg, Gs^Fp, Gg, Gs^Fp, Gs^Fp, Gs^Fp, Gs^Fp, Gs^Fp, Gg, Gg, Gs^Fp, Gs^Fp, Re, Re, Gs^Fp, Gs^Fp, Gs^Fp, Gs^Fp
Gg, Gg, Gs^Fp, Gg, Gs^Fp, Gs^Fp, Gg, Gs^Fp, Gs^Fp, Gs^Fp, Gg, Gg^Vh, Ww, Ww, Ww, Gg, Gg^Efm, Gg, Gg, Gg, Gg, Gg, Gs^Fp, Gg, Gg, Gg, Gs^Fp, Re, Re, Gg, Gg, Gg
Gg, Gg, Gs^Fp, Gg, Gs^Fp, Gs^Fp, Gg, Gs^Fp, Gg, Gg, Ww, Gg, Gg, Ww, Ww, Gg, Gg, Gg^Efm, Gg, Gg, Gs^Fp, Gs^Fp, Gs^Fp, Gg, Gg, Gs^Fp, Gs^Fp, Re, Gg, Re, Gg, Gg
Gs^Fp, Gs^Fp, Gs^Fp, Gs^Fp, Gs^Fp, Gg, Gs^Fp, Gg, Gs^Fp, Gg, Gg, Ww, Ww, Ww, Gg, Ww, Ww, Gg, Ww, Gg, Gg, Gg, Gs^Fp, Gs^Fp, Gs^Fp, Gg, Gs^Fp, Gs^Fp, Gg, Re, Gg, Gg
Gs^Fp, Gs^Fp, Gs^Fp, Gs^Fp, Gs^Fp, Gg, Gs^Fp, Gs^Fp, Gg, Gs^Fp, Gs^Fp, Ww, Gg, Ww, Gs^Fp, Gg, Gs^Fp, Ww, Gg, Ww, Ww, Gg, Gs^Fp, Gs^Fp, Gs^Fp, Gg, Gg, Gg, Gg, Re, Gg, Gg
Gs^Fp, Gs^Fp, Gs^Fp, Gs^Fp, Gs^Fp, Gs^Fp, Gg, Gs^Fp, Gs^Fp, Gs^Fp, Gg, Gg, Gg, Gg, Gs^Fp, Gs^Fp, Ss, Gs^Fp, Gg, Gg, Gg^Vh, Ww, Ww, Gg^Vh, Gg, Gg, Gs^Fp, Gg, Re, Re, Gs^Fp, Gs^Fp
Gg, Gg, Gs^Fp, Gs^Fp, Gg, Gg, Gg, Gg, Gs^Fp, Gg, Gs^Fp, Gs^Fp, Ss, Gs^Fp, Gs^Fp, Gg, Gg, Gs^Fp, Ss, Gs^Fp, Gg, Gg, Gg, Ww, Ww, Gs^Fp, Gg, Re, Gs^Fp, Gs^Fp, Gg, Gg
Gs^Fp, Gs^Fp, Gg, Gg, Ww, Gg, Ww, Gg, Gs^Fp, Gs^Fp, Gg, Gs^Fp, Gs^Fp, Gg, Gs^Fp, Ss, Ss, Ss, Gg, Gs^Fp, Ss, Gs^Fp, Gg, Gg, Gg, Ww, Ww, Re, Gs^Fp, Gg, Gs^Fp, Gs^Fp
Gg, Gg, Gg, Ww, Ww, Ww, Wo, Ww, Ww, Gs^Fp, Gg, Gs^Fp, Ss, Ss, Ss^Vhs, Gs^Fp, Gg, Gs^Fp, Gg, Gg, Gs^Fp, Ss, Gs^Fp, Gs^Fp, Ww, Gg, Ww, Re, Gs^Fp, Gs^Fp, Gs^Fp, Gs^Fp
Gg, Gg, Ww, Ww, Wo, Wo, Wo, Wo, Ww, Ww, Gs^Fp, Gs^Fp, Gg, Gs^Fp, Ss, Gs^Fp, Gs^Fp, Ss, Ss, Gs^Fp, Gs^Fp, Gg, Gg, Ww, Gg, Ww, Gg, Re, Gg, Gg, Gg, Gg
Gg, Gg, Gg^Vh, Ww, Ww, Wo, Ww, Ww, Ww, Gg, Gs^Fp, Gg, Gs^Fp, Ss, Gs^Fp, Gg, Ss, Ss, Gs^Fp, Gg, Gg, Gg, Ww, Ww, Re, Gs^Fp, Gs^Fp, Re, Re, Gs^Fp, Gs^Fp, Gs^Fp
Gg, Gg, Gg, Ww, Ww, Ww, Ww, Ww, Gg, Gs^Fp, Gs^Fp, Ss, Gg, Gs^Fp, Gg, Ss, Ss, Gs^Fp, Ss, Gg, Gg, Ww, Ce, Ce, Ce, Re, Gs^Fp, Gs^Fp, Gg, Gs^Fp, Gs^Fp, Gs^Fp
Gs^Fp, Gs^Fp, Gs^Fp, Gg, Gg, Ww, Ce, Ww, Ww, Gg, Gg^Vh, Gs^Fp, Gg, Ss, Ss, Gs^Fp, Gs^Fp, Ss, Ss, Gg, Ww, Ww, Ce, 2 Ke, Ce, Re, Re, Gs^Fp, Gs^Fp, Gg, Gs^Fp, Gs^Fp
Gg, Gg, Gs^Fp, Gs^Fp, Gs^Fp, Ce, 4 Ke, Ce, Gg, Ww, Gg, Gg, Gs^Fp, Gg, Gg, Ss, Gs^Fp, Gg, Gg, Gg, Ww, Gg, Gg, Ce, Gs^Fp, Gs^Fp, Gs^Fp, Re, Rd, Gg, Gs^Fp, Gs^Fp
Gs^Fp, Gs^Fp, Gg, Gs^Fp, Gs^Fp, Ce, Ce, Ce, Ww, Ww, Gg, Gg, Gs^Fp, Gs^Fp, Ss, Gs^Fp, Gg, Ss, Gg, Gs^Fp, Gs^Fp, Ww, Gg, Gs^Fp, Gg, Gg, Gg, Gs^Fp, Rd, Gs^Fp, Gs^Fp, Gs^Fp
Gs^Fp, Gs^Fp, Gg, Gg, Gs^Fp, Gs^Fp, Gg, Gg, Gg, Ww, Ww, Gg, Gg, Gg, Ss, Ss, Gg, Gs^Fp, Gs^Fp, Gs^Fp, Gg, Ww, Ww, Gg, Hh, Gg, Gg, Gg, Gs^Fp, Rd, Rd, Rd
Gs^Fp, Gs^Fp, Gs^Fp, Gs^Fp, Gs^Fp, Gs^Fp, Gs^Fp, Gs^Fp, Gs^Fp, Gg^Vh, Gg, Ww, Ww, Gs^Fp, Gs^Fp, Gs^Fp, Gg, Gs^Fp, Gg, Gg, Gs^Fp, Gg, Hh, Ww, Ww, Hh, Hh, Gg, Gs^Fp, Gs^Fp, Rd, Rd
Gg, Gg, Gs^Fp, Gg, Gg, Gg, Gs^Fp, Gs^Fp, Gs^Fp, Gs^Fp, Gs^Fp, Gg, Gg, Ww, Ww, Gg, Gg, Gg, Ww, Gs^Fp, Ww, Gs^Fp, Hh, Hh, Gs^Fp, Ww, Hh, Gg, Gg, Rd, Gs^Fp, Gs^Fp
Gs^Fp, Gs^Fp, Gs^Fp, Gg^Vh, Gs^Fp, Gs^Fp, Gg, Gg, Gs^Fp, Gs^Fp, Gs^Fp, Gg, Gs^Fp, Gg, Gs^Fp, Ww, Ww, Ww, Gg, Ww, Gg, Ww, Gs^Fp, Gs^Fp, Ww, Ww, Ww, Hh, Gg, Rd, Gg, Gg
Gg, Gg, Gs^Fp, Gg, Gs^Fp, Gg, Gs^Fp, Gs^Fp, Gs^Fp, Gs^Fp, Gs^Fp, Gs^Fp, Gs^Fp, Gs^Fp, Gg, Gs^Fp, Gg, Gg, Gs^Fp, Gs^Fp, Gg, Ww, Ww, Ww, Gs^Fp, Gs^Fp, Ww, Gg, Gg, Rd, Gg, Gg
Gs^Fp, Gs^Fp, Gg, Gs^Fp, Gs^Fp, Gs^Fp, Gs^Fp, Gs^Fp, Gs^Fp, Gs^Fp, Gs^Fp, Gs^Fp, Gg, Gs^Fp, Gs^Fp, Gs^Fp, Gs^Fp, Gs^Fp, Ww, Gg, Ww, Ww, Gg, Gs^Fp, Ww, Ww, Hh, Hh, Rd, Rd, Gg, Gg
Gs^Fp, Gs^Fp, Gs^Fp, Gg, Gs^Fp, Gs^Fp, Gg, Gs^Fp, Gs^Fp, Gs^Fp, Gs^Fp, Gg, Gs^Fp, Gs^Fp, Gg, Gg, Ww, Ww, Gs^Fp, Ww, Gg, Gs^Fp, Gs^Fp, Gg, Gg, Ww, Ww, Gg, Rd, Gg, Gg, Gg
Gg, Gg, Gg, Gs^Fp, Gg, Gs^Fp, Gg, Gs^Fp, Gg, Gg, Gg, Gs^Fp, Gg, Gg, Ww, Ww, Gg, Gs^Fp, Gs^Fp, Gg, Gs^Fp, Gg, Gs^Fp, Gs^Fp, Gg, Gs^Fp, Gg, Ww, Ww, Rd, Re, Re
Gg, Gg, Gg, Gs^Fp, Gg, Gs^Fp, Gg, Gs^Fp, Gg, Gg, Gg, Gs^Fp, Gg, Gg, Ww, Ww, Gg, Gs^Fp, Gs^Fp, Gg, Gs^Fp, Gg, Gs^Fp, Gs^Fp, Gg, Gs^Fp, Gg, Ww, Ww, Rd, Re, Re
