Gg, Gg, Ce, Ce, Ce, Gg, Rd, Gg, Rd, Gs, Gg, Gs, Gs^Fp, Ww, Gs^Fp, Gg, Re, Gg, Gg, Gg, Gg, Gg, Gg, Gg, Gs, Gg, Gg
Gg, Gg, Ce, 1 Ke, Ce, Gg, Rd, Gg, Rd, Gs, Gg^Vh, Gs, Gs^Fp, Ww, Gs^Fp, Gg, Re, Gg, Ce, Gg, Gg, Gg, Gg, Gg, Gs, Gg, Gg
Gg, Gg, Gg, Ce, Rd, Rd, Gg, Rd, Gg, Rd, Rd, Rd, Ww^Bw\, Ww, Re, Re, Ce, Ce, Gg^Ve, Ce, Ce, Re, Re, Gg, Gg, Gs, Gs
Rd, Rd, Rd, Rd, Gg, Gg, Gs^Fp, Gg, Gs^Fp, Gg, Gs^Fp, Ww, Gg, Rd, Rd, Ce, Rr, Gg^Ve, Rr, Gg^Ve, Rr, Ce, Re, Gg, Gg^Vh, Gg, Gg
Gg, Gg, Gs, Rd, Rd, Gg, Gg, Ww, Ww, Gg, Ww, Ww, Ww, Gg^Vh, Rd, Rr, Rr, Rr, Rr, Rr, 3 Ke, Rd, Rd, Gg, Gs, Gs, Gs
Gs, Gs, Gg, Gg^Vh, Gg, Rd, Rd, Gg, Gg, Ww, Gg, Gg, Rd, Ww^Bw/, Re, Ce, Ce, Gg^Ve, Rr, Ce, Gg^Ve, Ce, Re, Rd, Gg, Gg, Gg
Gs^Fp, Gs^Fp, Gg, Gg, Re, Re, Gg, Rd, Rd, Gg^Vh, Rd, Rd, Gs^Fp, Ww, Ww, Re, Re, Ce, Ce, Gg^Ve, Ce, Ce, Re, Rd, Rd, Gg, Gg
Gs^Fp, Gs^Fp, Gs^Fp, Gg, Re, Gg, Gg, Gg, Gg, Rd, Gg, Gg, Gg, Gg, Ww, Gg, Gg, Re, Re, Ce, Gg, Re, Gg, Gg, Rd, Gg, Gg
Gs^Fp, Gs^Fp, Gs^Fp, Gs^Fp, Wwf, Ww, Ww, Gs^Fp, Ww, Ww, Ww, Gs^Fp, Ww, Ww, Gg, Gg, Gg, Gg, Gg, Re, Gg, Gg, Gs^Fp, Gg, Rd, Gs^Fp, Gs^Fp
Ww, Ww, Ww, Ww, Gg, Gg, Gg, Ww, Gg, Gs^Fp, Gg, Ww, Gg, Ww, Gg, Gs^Fp, Gs^Fp, Gg, Gg, Gg, Gs^Fp, Gg, Gs^Fp, Gs^Fp, Rd, Gs^Fp, Gs^Fp
Gg, Gg, Gs^Fp, Gg, Re, Gg^Vh, Gs, Gs, Gg, Gg, Gg, Gg, Gs^Fp, Gs^Fp, Gg^Vh, Gg, Gg, Gs^Fp, Gs^Fp, Gs^Fp, Gs, Gs^Fp, Gg, Gg, Rd, Rd, Rd
Gs^Fp, Gs^Fp, Gg, Gg, Re, Gg, Gg, Gg, Gg, Gg, Gg, Hh, Hh, Gg, Gg, Ww, Ww, Gg, Gs^Fp, Gs, Gg^Vh, Gs, Re, Rd, Gg, Gg, Gg
Gg, Gg, Gg, Re, Gg, Gg, Re, Gg, Gg, Gg, Gg, Gg, Gg, Gg, Gs^Fp, Gs^Fp, Ww, Gs^Fp, Re, Gg, Re, Re, Gg, Gg, Gs^Fp, Gs^Fp, Gs^Fp
Gg, Gg, Gg, Re, Re, Re, Chr, Gg, Gg, Gg, Gg, Gg, Gg, Hh, Gs^Fp, Gs^Fp, Wwf, Re, Gg, Gg, Gg, Gs^Fp, Gg, Gs^Fp, Gg, Gg, Gg
Gs^Fp, Gs^Fp, Gg, Re, Re, Chr, 2 Kh, Chr, Gg, Gs, Gg, Gg, Gg, Gg, Re, Re, Ww, Gg, Gg, Gg, Gs^Fp, Gs^Fp, Gg, Gg, Gs^Fp, Gg, Gg
Gs^Fp, Gs^Fp, Gg, Gg, Re, Chr, Chr, Chr, Gg, Gs, Gg^Vh, Gg, Gg, Re, Gs^Fp, Gs^Fp, Ww, Gs^Fp, Gs^Fp, Gg, Gg, Gg, Gg, Gs^Fp, Gs^Fp, Gg, Gg
Gg, Gg, Gs^Fp, Gg, Re, Re, Re, Re, Re, Re, Re, Re, Gg, Gg, Gg, Gs^Fp, Gg, Ww, Gs^Fp, Gg, Gg, Gs, Gs^Fp, Hh, Hh, Gs^Fp, Gs^Fp
Gg, Gg, Gs^Fp, Gs^Fp, Gg, Rd, Re, Re, Gg, Gg, Gg, Gg, Gg, Gs^Fp, Gg, Gg, Gs^Fp, Ww, Gg, Gg, Gg, Gs, Hh, Hh, Gg, Gg, Gg
Gs^Fp, Gs^Fp, Gg^Vh, Gg, Rd, Rd, Gg, Gg, Gg, Gg, Gg, Gg, Gg, Gs^Fp, Gg, Gg, Ww, Ww, Ww, Gs^Fp, Gs^Fp, Gg^Vh, Gs^Fp, Gg, Gs^Fp, Hh, Hh
Gs, Gs, Rd, Rd, Hh, Gs^Fp, Gs^Fp, Hh, Gg, Gg, Gg, Gg, Gs^Fp, Gg, Gs^Fp, Gs^Fp, Ww, Gs^Fp, Ww, Gs^Fp, Gg, Gg, Gg, Hh, Hh, Gs^Fp, Gs^Fp
Rd, Rd, Gg, Gs^Fp, Gg, Hh, Gg, Gg, Gg, Gg, Gs^Fp, Gs^Fp, Gs^Fp, Gg, Ww, Ww, Gs^Fp, Gs^Fp, Gs^Fp, Ww, Hh, Hh, Gs^Fp, Hh, Gg, Gg, Gg
Gg, Gg, Hh, Gg, Gg, Gg, Gg, Gg, Gg, Gg, Gg, Gs^Fp, Ww, Ww, Gg, Gg, Gs^Fp, Gg, Gg, Ww, Gg, Gg, Gg, Gg, Gg, Gg, Gg
Gg, Gg, Hh, Hh, Gg, Gg, Gg^Vh, Gg, Gg, Gg, Gs^Fp, Gg, Ww, Gg, Gs^Fp, Gg, Gs^Fp, Gg, Ww, Ww, Gs^Fp, Gg, Gg, Hh, Hh, Gg, Gg
Gg, Gg, Gs^Fp, Gs^Fp, Gs^Fp, Gg, Gg, Gg, Gg, Gg, Gs^Fp, Gs^Fp, Ww, Gg, Gs^Fp, Gs^Fp, Ww, Ww, Hh, Gg, Gs^Fp, Gs^Fp, Gs^Fp, Hh, Gg, Gg, Gg
Gg, Gg, Gg, Gs^Fp, Gg, Gg, Gg, Gg, Gg, Gg, Gs^Fp, Gs^Fp, Gg, Ww, Ww, Gs^Fp, Ww, Hh, Gg, Gg, Gg, Gs^Fp, Gg, Gg, Gg, Gg, Gg
Gg, Gg, Gg, Gs^Fp, Gg, Gg, Gg, Gg, Gg, Gg, Gs^Fp, Gs^Fp, Gg, Ww, Ww, Gs^Fp, Ww, Hh, Gg, Gg, Gg, Gs^Fp, Gg, Gg, Gg, Gg, Gg
