border_size=1
usage=map

Aa^Fpa      , Aa^Fpa      , Aa^Fpa      , Aa^Fpa      , Aa          , Aa          , Ce          , Aa          , Aa          , Aa^Fpa      , Rd          , Rd          , Aa^Fpa      , Aa^Fpa      , Ai          , Ai          , Ai          , Ai          , Ai          , Aa          , Aa          , Aa          , Aa          , Aa          , Aa          , Aa          , Aa          , Ha          , Aa          , Rd          , Rd          , Re          , Aa          , Aa          , Ha          , Ha          , Ha          
Aa^Fpa      , Aa^Fpa      , Aa^Fpa      , Aa^Fpa      , Aa          , Aa          , Ce          , Aa          , Aa          , Aa^Fpa      , Rd          , Rd          , Aa^Fpa      , Aa^Fpa      , Ai          , Ai          , Ai          , Ai          , Ai          , Aa          , Aa          , Aa          , Aa          , Aa          , Aa          , Aa          , Aa          , Ha          , Aa          , Rd          , Rd          , Re          , Aa^Vha      , Aa          , Ha          , Ha          , Ha          
Aa          , Aa^Vha      , Aa          , Aa          , Re          , Ce          , 2 Ke        , Ce          , Re          , Aa          , Rd          , Aa          , Aa          , Aa          , Aa          , Ai          , Aa          , Ai          , Aa          , Aa          , Aa^Fpa      , Aa          , Aa^Fpa      , Aa^Fpa      , Aa^Fpa      , Aa          , Aa          , Ha          , Ha          , Ha          , Aa          , Rd          , Aa          , Aa          , Ha          , Ha          , Ha          
Aa          , Aa          , Aa          , Aa          , Aa          , Ce          , Ce          , Ce          , Re          , Rd          , Aa          , Rd          , Rd          , Aa^Fpa      , Rd          , Aa          , Rd          , Ww          , Aa          , Aa          , Aa          , Aa          , Aa          , Aa^Fpa      , Aa^Fpa      , Aa^Fpa      , Aa          , Aa          , Aa          , Ha          , Ha          , Rd          , Aa          , Aa          , Ha          , Ha          , Ha          
Rd          , Rd          , Rd          , Aa          , Aa          , Aa          , Aa          , Re          , Rd          , Rd          , Aa^Fpa      , Aa^Fpa      , Aa^Fpa      , Rd          , Aa          , Rd          , Aa^Vha      , Ww^Bw\      , Rd          , Aa          , Rd          , Aa          , Rd          , Aa          , Aa          , Aa          , Re          , Aa          , Aa          , Aa          , Ha          , Rd          , Rd          , Aa          , Aa          , Ha          , Ha          
Aa          , Aa          , Aa          , Rd          , Rd          , Aa          , Aa^Fpa      , Aa          , Rd          , Aa          , Aa^Fpa      , Aa^Fpa      , Aa^Fpa      , Aa          , Aa          , Aa          , Ai          , Ww          , Aa          , Rd          , Aa^Fpa      , Rd          , Aa          , Rd          , Rd          , Aa^Vha      , Rd          , Rd          , Rd          , Rd          , Rd          , Aa          , Rd          , Aa          , Re          , Aa          , Aa          
Aa^Fpa      , Aa^Fpa      , Aa^Fpa      , Aa          , Rd          , Aa^Fpa      , Rd          , Rd          , Re          , Aa          , Aa          , Aa^Fpa      , Aa          , Aa          , Ai          , Ai          , Ai          , Aa          , Aa^Fpa      , Aa^Fpa      , Aa          , Aa          , Ha          , Aa          , Aa          , Rd          , Re          , Re          , Aa          , Aa          , Aa^Fpa      , Rd          , Rd          , Re          , Aa          , Re          , Re          
Aa^Fpa      , Aa^Fpa      , Aa^Fpa      , Aa^Fpa      , Aa          , Rd          , Rd          , Re          , Aa          , Aa          , Aa^Fpa      , Aa          , Aa          , Ai          , Ai          , Ai          , Ai          , Aa          , Aa          , Aa          , Ha          , Ha          , Mm          , Ha          , Aa          , Aa          , Aa          , Aa          , Aa^Fpa      , Aa^Fpa      , Aa          , Aa          , Rd          , Aa          , Aa          , Aa^Fpa      , Aa^Fpa      
Aa          , Aa          , Aa          , Aa          , Aa          , Re          , Aa          , Rd          , Aa          , Aa^Fpa      , Aa          , Aa          , Ai          , Ai          , Aa          , Ai          , Aa          , Aa          , Ha          , Aa          , Ha          , Mm          , Ha          , Ha          , Aa          , Aa          , Aa^Fpa      , Aa^Fpa      , Aa          , Aa          , Aa          , Rd          , Aa          , Aa          , Aa^Fpa      , Aa^Fpa      , Aa^Fpa      
Aa          , Aa          , Aa          , Aa          , Aa          , Aa^Fpa      , Aa          , Rd          , Aa^Fpa      , Aa^Fpa      , Aa          , Aa          , Ww          , Aa          , Aa          , Aa          , Ha          , Ha          , Mm          , Mm          , Ha          , Mm          , Ha          , Aa          , Aa^Fpa      , Aa          , Aa^Fpa      , Aa          , Aa^Fpa      , Aa^Fpa      , Aa^Fpa      , Rd          , Aa^Fpa      , Aa          , Aa^Fpa      , Aa^Vha      , Aa          
Aa          , Aa          , Aa          , Aa          , Aa^Vha      , Aa^Fpa      , Rd          , Rd          , Aa^Fpa      , Aa^Fpa      , Aa          , Aa          , Ai          , Aa          , Aa          , Ha          , Ha          , Mm          , Ha          , Mm          , Ha          , Ha          , Aa^Fpa      , Aa^Fpa      , Qxu         , Aa^Fpa      , Aa^Fpa      , Aa^Fpa      , Aa^Vha      , Aa          , Rd          , Rd          , Aa          , Aa^Fpa      , Rd          , Rd          , Rd          
Aa          , Aa          , Aa          , Aa          , Aa          , Aa          , Rd          , Aa          , Aa          , Aa          , Aa          , Aa          , Ww          , Aa          , Ha          , Ha          , Mm          , Mm          , Ha          , Ha          , Aa          , Aa          , Aa          , Qxu         , Aa          , Aa^Fpa      , Aa^Fpa      , Aa^Fpa      , Aa          , Aa          , Rd          , Re          , Rd          , Rd          , Aa          , Aa          , Aa          
Aa          , Aa          , Aa^Fpa      , Aa^Fpa      , Aa          , Rd          , Aa          , Aa          , Aa^Fpa      , Aa          , Ww          , Ww          , Aa          , Aa          , Mm          , Mm          , Ha          , Ha          , Aa          , Aa^Fpa      , Aa          , Aa^Vha      , Aa          , Qxu         , Aa          , Aa          , Aa          , Aa          , Aa          , Aa          , Rd          , Rd          , Chr         , Aa          , Aa          , Aa          , Aa          
Aa^Fpa      , Aa^Fpa      , Aa^Fpa      , Aa          , Aa          , Rd          , Aa          , Aa^Fpa      , Aa          , Aa          , Ww          , Aa          , Aa          , Ha          , Mm          , Ha          , Ha          , Aa          , Aa          , Aa^Fpa      , Aa^Fpa      , Aa^Fpa      , Aa^Fpa      , Qxu         , Qxu         , Aa          , Aa          , Aa          , Aa          , Aa          , Rd          , Chr         , 3 Kh        , Chr         , Aa          , Aa          , Aa          
Aa          , Aa          , Aa          , Aa          , Aa          , Rd          , Aa^Fpa      , Aa          , Aa          , Aa          , Ai          , Aa          , Aa          , Ha          , Ha          , Ha          , Aa          , Aa          , Aa^Fpa      , Aa          , Aa          , Aa^Fpa      , Aa^Fpa      , Aa^Fpa      , Aa          , Aa          , Re          , Re          , Rd          , Rd          , Re          , Chr         , Chr         , Chr         , Aa          , Aa          , Aa          
Aa          , Aa          , Aa          , Aa^Fpa      , Aa          , Rd          , Aa          , Aa          , Aa          , Aa          , Ww          , Aa          , Aa          , Aa          , Aa          , Aa          , Aa          , Aa^Fpa      , Aa^Vha      , Aa          , Aa^Fpa      , Aa          , Aa          , Aa^Fpa      , Aa          , Aa          , Rd          , Rd          , Aa          , Re          , Aa          , Re          , Aa          , Aa          , Aa          , Aa          , Aa          
Aa          , Aa          , Aa          , Aa          , Aa          , Rd          , Aa          , Aa          , Aa          , Aa          , Aa^Fpa      , Ww          , Ww          , Ai          , Ai          , Ai          , Aa          , Aa^Fpa      , Aa^Fpa      , Aa          , Aa^Fpa      , Aa          , Aa          , Aa          , Rd          , Rd          , Re          , Aa          , Aa          , Aa          , Aa          , Aa          , Aa          , Aa          , Aa          , Aa          , Aa          
Aa          , Aa          , Aa          , Aa          , Aa^Fpa      , Rd          , Rd          , Aa^Fpa      , Aa          , Aa          , Ai          , Ai          , Ai          , Ww          , Ww          , Ai          , Ww          , Aa          , Aa          , Aa          , Aa^Fpa      , Aa          , Aa          , Aa          , Rd          , Aa          , Aa^Fpa      , Aa^Vha      , Aa^Fpa      , Aa          , Aa          , Re          , Aa          , Aa          , Aa^Fpa      , Aa^Fpa      , Aa^Fpa      
Aa          , Aa          , Aa          , Aa^Fpa      , Aa^Vha      , Aa^Fpa      , Rd          , Aa^Fpa      , Aa          , Aa          , Aa          , Ai          , Ai          , Ai          , Ai          , Ww          , Aa^Fpa      , Ww          , Ai          , Aa          , Aa          , Aa          , Aa          , Aa^Fpa      , Aa^Fpa      , Rd          , Aa          , Aa^Fpa      , Re          , Aa^Fpa      , Aa          , Aa          , Aa          , Aa^Fpa      , Aa          , Aa          , Aa          
Aa          , Aa          , Aa          , Aa          , Aa          , Aa          , Re          , Rd          , Rd          , Aa          , Aa          , Aa          , Ai          , Aa^Fpa      , Aa          , Aa^Fpa      , Aa          , Aa^Fpa      , Aa          , Ww          , Aa          , Aa          , Aa          , Aa          , Aa          , Rd          , Re          , Re          , Aa          , Aa^Fpa      , Aa^Fpa      , Aa          , Aa          , Aa^Fpa      , Aa          , Aa          , Aa          
Aa          , Aa          , Rd          , Rd          , Rd          , Aa          , Rd          , Rd          , Aa          , Rd          , Rd          , Aa          , Aa          , Aa          , Aa          , Aa^Fpa      , Aa^Vha      , Aa^Fpa      , Aa^Fpa      , Ww          , Aa^Fpa      , Aa          , Aa^Fpa      , Aa^Fpa      , Rd          , Rd          , Aa          , Re          , Aa          , Aa          , Aa^Fpa      , Aa          , Aa          , Aa          , Aa          , Aa          , Aa          
Aa          , Aa          , Rd          , Aa          , Ce          , Rd          , Aa          , Aa          , Aa^Fpa      , Aa          , Aa          , Rd          , Rd          , Rd          , Rd          , Aa^Fpa      , Aa^Fpa      , Aa          , Aa^Fpa      , Ai          , Ai          , Aa^Fpa      , Aa          , Aa          , Rd          , Aa^Fpa      , Aa^Fpa      , Aa          , Aa^Fpa      , Aa^Fpa      , Aa^Fpa      , Aa          , Re          , Re          , Aa          , Aa^Fpa      , Aa^Fpa      
Aa          , Aa          , Rd          , Ce          , 1 Ke        , Ce          , Aa          , Aa          , Aa          , Aa          , Aa          , Re          , Aa          , Aa          , Aa          , Rd          , Aa          , Aa^Fpa      , Aa^Fpa      , Ww          , Ww          , Aa          , Aa          , Aa          , Rd          , Aa^Fpa      , Aa^Fpa      , Aa^Fpa      , Aa          , Aa          , Aa          , Aa          , Aa          , Aa          , Aa^Vha      , Aa          , Aa          
Aa          , Aa          , Rd          , Ce          , Ce          , Ce          , Aa          , Aa          , Aa          , Aa          , Aa          , Aa          , Qxu         , Qxu         , Aa          , Rd          , Rd          , Qxu         , Aa^Fpa      , Aa^Fpa      , Aa^Fpa      , Ww          , Aa^Fpa      , Aa          , Rd          , Aa          , Aa          , Aa          , Aa          , Aa          , Aa          , Aa          , Aa          , Aa          , Aa          , Aa^Fpa      , Aa^Fpa      
Aa          , Aa          , Rd          , Aa          , Aa          , Aa          , Aa          , Aa          , Aa          , Aa          , Aa^Fpa      , Aa          , Qxu         , Aa          , Aa          , Re          , Aa          , Rd          , Aa^Fpa      , Aa^Fpa      , Ww          , Ww          , Rd          , Rd          , Aa          , Aa          , Aa          , Aa          , Re          , Aa          , Aa          , Aa^Fpa      , Aa^Fpa      , Aa^Fpa      , Aa          , Aa^Fpa      , Aa^Fpa      
Aa^Fpa      , Aa^Fpa      , Aa          , Rd          , Rd          , Re          , Aa          , Aa          , Aa          , Aa          , Aa          , Aa          , Qxu         , Aa          , Aa          , Aa          , Re          , Rd          , Rd          , Rd          , Ww^Bw/      , Rd          , Aa^Fpa      , Aa^Fpa      , Aa          , Aa          , Aa          , Aa          , Aa          , Aa          , Aa          , Aa          , Aa          , Aa          , Aa          , Aa          , Aa          
Aa^Fpa      , Aa^Fpa      , Aa          , Rd          , Rd          , Re          , Aa          , Aa          , Aa          , Aa          , Aa          , Aa          , Qxu         , Aa          , Aa          , Aa          , Re          , Rd          , Rd          , Rd          , Ww^Bw/      , Rd          , Aa^Fpa      , Aa^Fpa      , Aa          , Aa          , Aa          , Aa          , Aa          , Aa          , Aa          , Aa          , Aa          , Aa          , Aa          , Aa          , Aa          
