Gs^Fp, Gs^Fp, Gs^Fp, Rd, Rd, Gs^Fp, Gs^Fp, Gs^Fp, Gs^Fp, Gs^Fp, Gg, Gg, Gg, Gg, Ss, Gg, Ww, Gg, Gg, Ww, Gg, Gg
Gs^Fp, Gs^Fp, Gs^Fp, Rd, Rd, Gs^Fp, Gs^Fp, Gs^Fp, Gs^Fp, Gs^Fp, Gg, Gg, Gg, Gg, Ss, Gg, Ww, Gg, Gg, Ww, Gg, Gg
Gs^Fp, Gs^Fp, Gs^Fp, Gs^Fp, Gs^Fp, Rd, Rd, Gs^Fp, Gg, Gg, Gg, Gg, Gg, Gg, Ww, Ww, Gg, Ww, Ww, Ww, Gg, Gg
Gs^Fp, Gs^Fp, Gs^Fp, Gs^Fp, Gs^Fp, Gs^Fp, Gs^Fp, Rd, Gg, Gg, Gg, Gg, Gg, Gg, Ww, Ss, Gg, Gg, Gs^Fp, Gg, Gg, Gg
Gs^Fp, Gs^Fp, Gs^Fp, Gs^Fp, Gs^Fp, Gs^Fp, Gg, Rd, Rd, Gg, Gg, Gg, Gg, Ww, Gg, Gg, Gs^Fp, Gg, Gg, Gs^Fp, Gs^Fp, Gs^Fp
Gs^Fp, Gs^Fp, Gs^Fp, Gs^Fp, Gs^Fp, Gs^Fp, Gg, Gg, Gg, Rd, Rd, Gg, Gg, Ww, Ww, Gg, Gs^Fp, Gs^Fp, Gs^Fp, Gg, Gs^Fp, Gs^Fp
Gs^Fp, Gs^Fp, Gs^Fp, Gg^Vh, Gs^Fp, Gs^Fp, Gg, Gg, Gg, Gg, Gg, Rd, Gg, Gs^Fp, Ww, Gg, Gg, Gs^Fp, Gg, Gs^Fp, Gg, Gg
Gs^Fp, Gs^Fp, Gs^Fp, Gs^Fp, Gs^Fp, Gs^Fp, Gg, Gg, Gg, Gg, 1 Kh, Rd, Rd, Gg, Ww, Gg, Gg, Gs^Fp, Gs^Fp, Gs^Fp, Gs^Fp, Gs^Fp
Gs^Fp, Gs^Fp, Gg, Gs^Fp, Gg, Gg, Gg, Gg, Gg, Gg, Gg, Gg, Rd, Rd, Ww^Bw\, Gg, Gg^Vh, Gs^Fp, Rd, Rd, Rd, Rd
Gg, Gg, Gg, Gg, Gg, Gg, Gg, Gg, Gg, Gg, Gg, Rd, Gg, Gg, Ww, Rd, Rd, Rd, Gs^Fp, Gs^Fp, Gs^Fp, Gs^Fp
Gg, Gg, Gg, Gg, Gg, Gg, Gg, Gg, Gg, Gg, Rd, Rd, Gg, Gg, Ww, Gg, Gg, Gg, Gg, Gs^Fp, Gs^Fp, Gs^Fp
Gg, Gg, Gg, Gg, Gg, Gg, Gg, Gg, Gg, Gg, Rd, Gg, Gg, Ww, Gs^Fp, Gg, Gg, Gg, Gg, Gg, Gg, Gg
Gg, Gg, Gg, Gg, Gg, Gg, Gg, Gg, Rd, Rd, Gg, Rd, Gg, Ww, Gg, Gg, Gg, Gg, Gg, Gg, Gg, Gg
Gg, Gg, Gg, Gg, Gg^Vh, Gg, Rd, Rd, Gg, Gg, Gg, Rd, Gg, Ww, Gg, Gg, Gg, Gg, Gg, Gg, Gg, Gg
Gg, Gg, Rd, Rd, Rd, Rd, Gg, Gg, Gg, Gg, Gg, Rd, Rd, Ww, Gg, Gg, Gg, Gg, Gg, Gg, Hh, Hh
Rd, Rd, Gg, Gg, Gg, Gg, Gg, Gg, Gg, Gg, Gg, Gg, Gg, Ww^Bw\, Rd, Gg, Rd, Gg, Gg, Hh, Hh, Hh
Gg, Gg, Gg, Gg, Gg, Gg, Gg, Gg, Gg, Gg, Gg, Gg, Gs^Fp, Ww, Gg, Rd, Gg, Rd, Rd, Gg, Gg, Gg
Gg, Gg, Gg, Gg, Gg, Gg, Gg, Gg, Gg, Gg, Gg, Gg, Gg, Ww, Ww, Hh, Hh, Hh, Gs^Fp, Rd, Rd, Rd
Gg, Gg, Gg, Gg, Gg, Gs^Fp, Gs^Fp, Gg, Gg, Gg, Gs^Fp, Gs^Fp, Hh, Hh, Gs^Fp, Ww, Gg, Gs^Fp, Gs^Fp, Gg^Vh, Gg, Gg
Gg, Gg, Gg, Gg, Gg, Gg, Gs^Fp, Gg, Gs^Fp, Gs^Fp, Gs^Fp, Gs^Fp, Hh, Gs^Fp, Hh, Hh, Gs^Fp, Gg, Hh, Hh, Gg, Gg
Gg, Gg, Gg, Gg, Gg, Gg, Gg, Gg, Gs^Fp, Gs^Fp, Gs^Fp, Hh, Gg, Gs^Fp, Hh, Gs^Fp, Hh, Hh, Gs^Fp, Hh, Gs^Fp, Gs^Fp
Xu, Xu, Xu, Xu, Xu, Xu, Xu, Xu, Xu, Xu, Xu, Xu, Xu, Xu, Xu, Xu, Xu, Xu, Xu, Xu, Xu, Xu
Rd, Rd, Rd, Rd, Rd, Rd, Rd, Rd, Rd, Rd, Rd, Rd, Rd, Rd, Rd, Rd, Rd, Rd, Rd, Rd, Rd, Rd
Rd, Rd, Rd, Rd, Rd, Rd, Rd, Rd, Rd, Rd, Rd, Rd, Rd, Rd, Rd, Rd, Rd, Rd, Rd, Rd, Rd, Rd
