Gg, Gg, Gs^Fp, Gg, Gg, Gg, Gs^Fp, Gg, Gg, Gg, Gg, Gg, Gg, Gg, Gg, Gg, Gg, Gg, Hh, Hh, Mm, Mm, Mm, Mm
Gg, Gg, Gs^Fp, Gg, Gg, Gg, Gs^Fp, Gg, Gg, Gg, Gg, Gg, Gg, Gg, Gg, Gg, Gg, Gg, Hh, Hh, Mm, Mm, Mm, Mm
Gs^Fp, Gs^Fp, Rd, Gg, Gg, Gs^Fp, Gg, Gg, Gg, Gg, Gg, Gg, Gg, Gg, Gg, Gg, Gg, Gg, Hh, Hh, Hh, Hh, Mm, Mm
Rd, Rd, Gs^Fp, Rd, Rd, Gg, Gg, Gg, Gg, Gg, Gs^Fp, Gg, Gg, Gg, Gg, Gg, Gg, Gg, Hh, Mm, Mm, Mm, Mm, Mm
Gs^Fp, Gs^Fp, Gg, Gg, Gg, Rd, Rd, Gg, Gg, Gg, Gg, Gs^Fp, Gs^Fp, Gg, Gg, Gg, Gg, Gg, Hh, Hh, Hh, Mm, Hh, Hh
Gg, Gg, Gg, Gg, Gg, Gg, Rd, Re, Re, Gg, Gg, Re, Re, Re, Gg, Gg, Gg, Gg, Gg, Hh, Hh, Hh, Hh, Hh
Gg, Gg, Gg, Gg, Gg, Gg, Rd, Rd, Rd, Re, Gg, Gg, Gg, Gg, Gg, Gg, Gg, Gg, Gg, Gg, Gs^Fp, Gg, Gg, Gg
Gs^Fp, Gs^Fp, Gs^Fp, Gg, Gg, Gg, Rd, 1 Kh, Gg, Rd, Rd, Rd, Rd, Gg, Gg, Re, Re, Gg, Gg, Gs^Fp, Re, Gs^Fp, Kh, Ch
Gg, Gg, Gg, Gg, Rd, Rd, Gg, Re, Gg, Gg, Gg, Gg, Re, Rd, Rd, Gg, Gg, Gg, Gg, Gg, Re, Chr, Rd, Rd
Hh, Hh, Rd, Rd, Gg, Gg, Gg, Gg, Ss, Re, Ss, Re, Gg, Re, Rd, Rd, Rd, Rd, Rd, Rd, Rd, Rd, Re, Re
Rd, Rd, Gg, Gg, Gg, Gg, Gg, Gg, Gg, Ss, Gg, Gg, Gg, Gg, Rd, Gg, Gg, Gg^Vh, Gg, Gg, Gg, Re, Hh, Hh
Gs^Fp, Gs^Fp, Hh, Gg, Gg, Gg, Ss, Ss, Gg, Gg, Gg, Gg, Gg, Gg, Rd, Re, Gs^Fp, Gg, Gg, Gg, Gg, Gg, Gg, Gg
Gs^Fp, Gs^Fp, Gg, Gg, Gg, Gg, Gg, Gg, Gg, Gg, Gg, Gg, Rd, Rd, Rd, Gg, Gg, Gg, Gg, Gg, Hh, Gg, Hh, Hh
Gg, Gg, Gg, Ss, Ss, Gg, Gg, Gg, Gg, Gg, Rd, Rd, Gg, Gg, Rd, Gg, Gg, Gg, Gg, Hh, Hh, Hh, Hh, Hh
Gg, Gg, Gg, Gg, Gg, Gg, Gg, Gg, Rd, Rd, Gg, Gg, Gg, Gg, Re, Ss, Ss, Gg, Gg, Gg, Gg, Gg, Gg, Gg
Gg, Gg, Gg, Gg, Gg, Gg, Rd, Rd, Gg, Gg, Ss, Ss, Gg, Gg, Gg, Re, Ss, Ss, Ss, Gs^Fp, Ss, Gs^Fp, Re, Re
Gg, Gg, Gg, Gg, Rd, Rd, Gg, Gg, Gg, Gg, Gg, Ss, Gg, Gs^Fp, Gs^Fp, Re, Re, Gg, Gs^Fp, Ss, Re, Re, Ss, Ss
Gg, Gg, Gg, Gg, Rd, Gg^Vh, Gg, Gg, Gg, Gg, Ss, Gg, Ss, Gs^Fp, Gg, Ss, Re, Gs^Fp, Ww, Gs^Fp, Re, Ss, Gg, Gg
Gg, Gg, Gg, Gg, Rd, Gg, Gg, Gg, Gs^Fp, Gg, Gg, Ss, Ss, Ss, Ss, Ss, Gs^Fp, Wwf, Chr, Ww, Wwf, Ss, Ww, Ww
Gs^Fp, Gs^Fp, Gs^Fp, Gs^Fp, Gg, Rd, Gg, Gg, Gg, Gg, Gg, Ss, Ss, Ss, Gs^Fp, Gg, Gg, Ww, Kh, Chw, Ww, Ww, Ww, Ww
Gg, Gg, Gg, Gs^Fp, Gg, Rd, Gs^Fp, Gg, Re, Gg, Re, Re, Re, Re, Re, Gs^Fp, Re, Wwf, Ww, Wwf, Wwf, Ww, Gg, Gg
Gg, Gg, Gg, Gg, Rd, Rd, Re, Re, Gs^Fp, Re, Gg, Gs^Fp, Gg, Gs^Fp, Gg, Re, Ww, Ww, Ww, Ww, Ss, Re, Re, Re
Hh, Hh, Gs^Fp, Rd, Hh, Gg, Gs^Fp, Gs^Fp, Gs^Fp, Gs^Fp, Gg, Gg, Ww, Ww, Ww, Ww, Ww, Ww, Ss, Gg, Gs^Fp, Ss, Re, Re
Xu, Xu, Xu, Xu, Xu, Xu, Xu, Xu, Xu, Xu, Xu, Xu, Xu, Xu, Xu, Xu, Xu, Xu, Xu, Xu, Xu, Xu, Xu, Xu
Rd, Rd, Rd, Rd, Rd, Rd, Rd, Rd, Rd, Rd, Rd, Rd, Rd, Rd, Rd, Rd, Rd, Rd, Rd, Rd, Rd, Rd, Rd, Rd
Rd, Rd, Rd, Rd, Rd, Rd, Rd, Rd, Rd, Rd, Rd, Rd, Rd, Rd, Rd, Rd, Rd, Rd, Rd, Rd, Rd, Rd, Rd, Rd
