border_size=1
usage=map

Ww          , Ww          , Ww          , Ww          , Ww          , Ww          , Ww          , Gs^Fp       , Gs^Fp       , Gs^Fp       , Ww          , Gg          , Gg          , Gg          , Gs^Fp       , Gg          , Gg          , Gs^Fp       , Ww          , Ww          , Ww          , Gs^Fp       , Gs^Fp       , Ww          , Gs^Fp       , Ww          , Gs^Fp       , Gs^Fp       , Gs^Fp       , Gs^Fp       , Gs^Fp       , Gs^Fp       , Gs^Fp       , Gs^Fp       
Ww          , Ww          , Ww          , Ww          , Ww          , Ww          , Ww          , Gs^Fp       , Gs^Fp       , Gs^Fp       , Ww          , Gg          , Gg          , Gg          , Gs^Fp       , Gg          , Gg          , Gs^Fp       , Ww          , Ww          , Ww          , Gs^Fp       , Gs^Fp       , Ww          , Gs^Fp       , Ww          , Gs^Fp       , Gs^Fp       , Gs^Fp       , Gs^Fp       , Gs^Fp       , Gs^Fp       , Gs^Fp       , Gs^Fp       
Gs^Fp       , Gs^Fp       , Gs^Fp       , Gs^Fp       , Gs^Fp       , Gs^Fp       , Gs^Fp       , Ww          , Gs^Fp       , Gs^Fp       , Ww          , Gg          , Gg          , Gs^Fp       , Gs^Fp       , Gs^Fp       , Gs^Fp       , Gg          , Ww^Bw\      , Gs^Fp       , Gs^Fp       , Gs^Fp       , Gs^Fp       , Gs^Fp       , Gs^Fp       , Gs^Fp       , Chr         , Ss          , Ss          , Ww          , Ww          , Ss          , Gs^Fp       , Gs^Fp       
Gs^Fp       , Gs^Fp       , Gs^Fp       , Gs^Fp       , Gs^Fp       , Gs^Fp       , Gs^Fp       , Gs^Fp       , Gs^Fp       , Gs^Fp       , Gg          , Gg^Vh       , Gs^Fp       , Gs^Fp       , Gs^Fp       , Ww          , Gs^Fp       , Gs^Fp       , Ww          , Re          , Ss^Vhs      , Ww          , Ww          , Re          , Re          , Chr         , 2 Kh        , Chs         , Ss          , Ss          , Ww          , Ww          , Gs^Fp       , Gs^Fp       
Gg          , Gg          , Gg          , Gs^Fp       , Gs^Fp       , Ww          , Gg          , Gs^Fp       , Gg          , Gg          , Gs^Fp       , Gg          , Ww          , Re          , Gs^Fp       , Ww          , Ww          , Ww          , Re          , Re          , Re          , Ss          , Ww^Bw/      , Re          , Gs^Fp       , Chw         , Chw         , Chs         , Ss          , Ss          , Gs^Fp       , Ww          , Gs^Fp       , Gs^Fp       
Gg          , Gg          , Gg          , Gg^Vh       , Re          , Gg          , Gs^Fp       , Gg          , Gs^Fp       , Gs^Fp       , Gs^Fp       , Gg          , Ss          , Ss          , Gs^Fp       , Gs^Fp       , Ww^Bw/      , Ww^Bw/      , Ww          , Ww          , Gs^Fp       , Re          , Ss          , Gs^Fp       , Gs^Fp       , Ww          , Ww          , Ww          , Ss          , Ss          , Ww          , Gs^Fp       , Gs^Fp       , Gs^Fp       
Gs^Fp       , Gs^Fp       , Gs^Fp       , Gg          , Gg          , Gs^Fp       , Ww          , Gs^Fp       , Ss          , Gs^Fp       , Ss          , Ss          , Re          , Gs^Fp       , Gs^Fp       , Re          , Ss          , Ww          , Gs^Fp       , Re          , Gs^Fp       , Gg          , Gs^Fp       , Ss          , Gs^Fp       , Gs^Fp       , Ww          , Ss          , Gs^Fp       , Gs^Fp       , Gs^Fp       , Ww          , Gs^Fp       , Gs^Fp       
Gs^Fp       , Gs^Fp       , Gs^Fp       , Gs^Fp       , Gg          , Gs^Fp       , Gs^Fp       , Gs^Fp       , Gs^Fp       , Gs^Fp       , Gs^Fp       , Ss          , Gs^Fp       , Gs^Fp       , Re          , Re          , Ss          , Ww          , Gs^Fp       , Gs^Fp       , Gs^Fp       , Gs^Fp       , Gs^Fp       , Ss          , Gs^Fp       , Ww          , Ww          , Ss^Vhs      , Ww          , Gs^Fp       , Ss          , Ww          , Gs^Fp       , Gs^Fp       
Gs^Fp       , Gs^Fp       , Ce          , Ce          , Ce          , Gs^Fp       , Ss          , Ss          , Gs^Fp       , Ww          , Ww          , Ww          , Ww^Bw/      , Re          , Re          , Ss          , Ss^Vhs      , Gs^Fp       , Gs^Fp       , Gs^Fp       , Ss          , Ss          , Gs^Fp       , Gs^Fp       , Gs^Fp       , Ww          , Ss          , Ww          , Ww          , Ww          , Ss          , Ss          , Gs^Fp       , Gs^Fp       
Gs^Fp       , Gs^Fp       , Ce          , 1 Ke        , Ce          , Gs^Fp       , Ss          , Gs^Fp       , Re          , Re          , Re          , Ww^Bw/      , Ww          , Gs^Fp       , Gs^Fp       , Re          , Re          , Gs^Fp       , Ss          , Ss          , Gs^Fp       , Gs^Fp       , Gs^Fp       , Gg          , Gs^Fp       , Ss          , Gg          , Gs^Fp       , Ww          , Ww          , Gs^Fp       , Gs^Fp       , Gs^Fp       , Gs^Fp       
Gs^Fp       , Gs^Fp       , Re          , Ce          , Re          , Ww^Bw\      , Re          , Ww^Bw/      , Gs^Fp       , Re          , Gs^Fp       , Gs^Fp       , Ss          , Gs^Fp       , Ss          , Gs^Fp       , Gs^Fp       , Ww^Bw\      , Ww^Bw\      , Ss          , Gs^Fp       , Gs^Fp       , Gg          , Gg^Vh       , Re          , Gg          , Re          , Ww          , Re          , Gg          , Gs^Fp       , Gs^Fp       , Gs^Fp       , Gs^Fp       
Re          , Re          , Gs^Fp       , Re          , Gs^Fp       , Gs^Fp       , Ss          , Ss^Vhs      , Gs^Fp       , Ss          , Ss          , Ss          , Gs^Fp       , Gs^Fp       , Gs^Fp       , Gs^Fp       , Gs^Fp       , Ss          , Ss          , Ww^Bw\      , Re          , Gs^Fp       , Re          , Re          , Gg          , Re          , Gg          , Re          , Ww          , Re          , Gs^Fp       , Gs^Fp       , Ss          , Ss          
Gg          , Gg          , Ss          , Gs^Fp       , Ss          , Gs^Fp       , Gs^Fp       , Gs^Fp       , Gs^Fp       , Gs^Fp       , Gs^Fp       , Gs^Fp       , Ww          , Gs^Fp       , Ww          , Gs^Fp       , Ss          , Ww          , Gs^Fp       , Gs^Fp       , Gs^Fp       , Re          , Gs^Fp       , Gs^Fp       , Gs^Fp       , Gg          , Ww          , Ww          , Gs^Fp       , Re          , Ww^Bw\      , Ss          , Gs^Fp       , Gs^Fp       
Gg          , Gg          , Ss          , Gs^Fp       , Gs^Fp       , Gs^Fp       , Ss          , Ss          , Ss          , Ss          , Ss          , Gs^Fp       , Gs^Fp       , Gs^Fp       , Ss          , Gs^Fp       , Ss          , Ss          , Gs^Fp       , Gs^Fp       , Gg          , Gg          , Ww          , Gs^Fp       , Ss          , Ww          , Ss          , Ww          , Ww          , Ss          , Re          , Re          , Gs^Fp       , Gs^Fp       
Gg          , Gg          , Gg          , Gs^Fp       , Ss          , Ss          , Ss          , Gs^Fp       , Gs^Fp       , Gs^Fp       , Ss          , Gs^Fp       , Ww          , Gs^Fp       , Ss          , Ss          , Ss^Vhs      , Ss          , Ww^Bw/      , Re          , Gs^Fp       , Gs^Fp       , Ss          , Ss          , Ss          , Ss^Vhs      , Gs^Fp       , Ww          , Ss          , Ss          , Re          , Gg          , Gg          , Gg          
Gs^Fp       , Gs^Fp       , Gg          , Gs^Fp       , Gs^Fp       , Gs^Fp       , Ss          , Ss          , Ss          , Gs^Fp       , Ww          , Ww          , Ww          , Ww          , Gs^Fp       , Ss          , Gs^Fp       , Gg          , Gs^Fp       , Ww          , Ww          , Ss          , Ss          , Ww          , Gs^Fp       , Gs^Fp       , Gs^Fp       , Ss          , Ce          , Gs^Fp       , Gs^Fp       , Re          , Re          , Re          
Ss          , Ss          , Re          , Ss          , Ss          , Ss          , Gs^Fp       , Gs^Fp       , Ss^Vhs      , Ss          , Ww          , Gs^Fp       , Gs^Fp       , Gs^Fp       , Ss          , Gs^Fp       , Gs^Fp       , Gs^Fp       , Gs^Fp       , Gs^Fp       , Ss          , Ss          , Ss          , Gs^Fp       , Gs^Fp       , Gs^Fp       , Ss          , Ce          , 3 Ke        , Ce          , Gs^Fp       , Ss          , Gg          , Gg          
Gs^Fp       , Gs^Fp       , Gs^Fp       , Re          , Ww^Bw\      , Ss          , Gs^Fp       , Ww          , Ss          , Gs^Fp       , Ww          , Gs^Fp       , Gg          , Ss          , Gs^Fp       , Gs^Fp       , Ss          , Ss          , Gs^Fp       , Ss          , Re          , Gs^Fp       , Ss^Vhs      , Gs^Fp       , Gs^Fp       , Ss          , Gs^Fp       , Ce          , Ce          , Ce          , Re          , Ww^Bw/      , Re          , Re          
Gs^Fp       , Gs^Fp       , Ss          , Ss^Vhs      , Ss          , Re          , Re          , Ww          , Ww          , Ww          , Gg          , Gg          , Gs^Fp       , Ww^Bw\      , Ww^Bw\      , Ss          , Gs^Fp       , Ss          , Ww^Bw/      , Ww^Bw/      , Ss          , Gg          , Gg          , Ss          , Re          , Ss          , Ww^Bw/      , Re          , Gg          , Gg          , Ww          , Ss          , Gs^Fp       , Gs^Fp       
Gs^Fp       , Gs^Fp       , Ss          , Gs^Fp       , Gs^Fp       , Ss          , Ss          , Re          , Re          , Re          , Gs^Fp       , Gs^Fp       , Ss          , Ss          , Gs^Fp       , Re          , Re          , Ww^Bw/      , Ss          , Ss          , Gs^Fp       , Gs^Fp       , Gs^Fp       , Ww^Bw/      , Ss          , Re          , Ss          , Ss          , Ss          , Ss          , Ww          , Ww          , Gs^Fp       , Gs^Fp       
Ss          , Ss          , Gs^Fp       , Gs^Fp       , Gs^Fp       , Gs^Fp       , Gs^Fp       , Ss          , Gs^Fp       , Gs^Fp       , Ss          , Ss          , Gs^Fp       , Gs^Fp       , Gs^Fp       , Gs^Fp       , Gs^Fp       , Ss          , Ss          , Ss          , Ss          , Ss          , Ss          , Ss          , Gs^Fp       , Ss          , Ww          , Ww          , Ww          , Ww          , Gs^Fp       , Gs^Fp       , Gs^Fp       , Gs^Fp       
Ss          , Ss          , Gs^Fp       , Gs^Fp       , Gs^Fp       , Gs^Fp       , Gs^Fp       , Ss          , Gs^Fp       , Gs^Fp       , Ss          , Ss          , Gs^Fp       , Gs^Fp       , Gs^Fp       , Gs^Fp       , Gs^Fp       , Ss          , Ss          , Ss          , Ss          , Ss          , Ss          , Ss          , Gs^Fp       , Ss          , Ww          , Ww          , Ww          , Ww          , Gs^Fp       , Gs^Fp       , Gs^Fp       , Gs^Fp       
