Gs^Fp, Gs^Fp, Gs^Fp, Gs^Fp, Gs^Fp, Gs^Fp, Gs^Fp, Gs^Fp, Gs^Fp, Gs^Fp, Gs^Fp, Gs^Fp, Gg, Gg, Gg, Gs^Fp, Gs^Fp, Gg, Gg, Gg, Gs^Fp, Gg, Gs^Fp, Gs^Fp, Gs^Fp, Gg, Gg, Gg, Gg, Gg, Gg, Gs^Fp, Gs^Fp, Gs^Fp, Gs^Fp, Gs^Fp, Gs^Fp
Gs^Fp, Gs^Fp, Gs^Fp, Gs^Fp, Gs^Fp, Gs^Fp, Gs^Fp, Gs^Fp, Gs^Fp, Gs^Fp, Gs^Fp, Gs^Fp, Gg, Gg, Gg, Gs^Fp, Gs^Fp, Gg, Gg, Gg, Gs^Fp, Gg, Gs^Fp, Gs^Fp, Gs^Fp, Gg, Gg, Gg, Gg, Gg, Gg, Gs^Fp, Gs^Fp, Gs^Fp, Gs^Fp, Gs^Fp, Gs^Fp
Gs^Fp, Gs^Fp, Rd, Gg, Rd, Gg, Gg^Vh, Gg, Gs^Fp, Gg, Gs^Fp, Gg, Ww, Ww, Ww, Gg, Gg, Gg, Gs^Fp, Gs^Fp, Gs^Fp, Gs^Fp, Gg, Gg, Gg, Gs^Fp, Gs^Fp, Gg, Gg, Gg, Rd, Rd, Rd, Gg, Gs^Fp, Gs^Fp, Gs^Fp
Rd, Rd, Gg, Rd, Ce, Rd, Rd, Gg, Gs^Fp, Gs^Fp, Gg, Gg, Ww, Ww, Ww, Gg, Gg, Gs^Fp, Gg, Gg, Gs^Fp, Gg, Gg, Gs^Fp, Rd, Gs^Fp, Gs^Fp, Gg, Rd, Rd, Ce, Ce, Ce, Rd, Gg, Gs^Fp, Gs^Fp
Gg, Gg, Gg, Ce, 4 Ke, Ce, Rd, Gg, Rd, Gg, Rd, Gg, Ss, Ww, Ss, Gg, Gg, Gs^Fp, Gg, Gg, Gg^Vh, Gs^Fp, Gs^Fp, Rd, Gs^Fp, Rd, Rd, Rd, Gg, Gg, Ce, 5 Ke, Ce, Rd, Rd, Gg^Vh, Gg
Gg, Gg, Gg, Ce, Ce, Ce, Gg, Rd, Gg^Vh, Rd, Gg, Rd, Rd, Ss, Gd^Vhr, Gg, Gs^Fp, Gs^Fp, Gs^Fp, Gg, Rd, Rd, Rd, Rd, Gs^Fp, Gg^Vh, Gs^Fp, Gs^Fp, Gg, Gg, Gg, Ce, Gg, Gg, Gg, Rd, Rd
Gs^Fp, Gs^Fp, Gg, Gg, Gg, Gg, Gg^Gvs, Gs, Gg, Gg, Gs^Fp, Gs^Fp, Gs^Fp, Rd, Rd, Gs^Fp, Rd, Rd, Rd, Rd, Gs^Fp, Gs^Fp, Gg, Gs^Fp, Gg, Gs^Fp, Gg, Gs^Fp, Gg, Gg, Gg, Gg, Gg, Gg, Gg, Gg, Gg
Gs^Fp, Gs^Fp, Gs^Fp, Gs^Fp, Gs^Fp, Gg, Gg, Gg, Gs^Fp, Gs^Fp, Gg, Gs^Fp, Gg, Gs^Fp, Gg, Rd, Gg, Gg, Rd, Gg, Gg, Gg, Gg, Gg, Gg, Gg, Gg, Gs^Fp, Gg, Gg, Gg, Gg, Gg, Gg, Gg, Gg, Gg
Gs^Fp, Gs^Fp, Gs^Fp, Gs^Fp, Gs^Fp, Gs^Fp, Gs^Fp, Gs^Fp, Gg, Gg, Gg, Gg, Gg, Gg, Gg, Gg, Ww, Ww, Ww^Bw|, Ww, Ww, Gg, Ww, Ww, Ww, Gg, Gg, Gg, Gg, Gg, Ww, Ww, Ww, Ww, Ww, Gg, Gg
Gg, Gg, Gg, Gg, Gg, Gg, Gg, Gg, Gg, Gg, Ww, Gg, Ww, Gg, Ww, Gg, Ww, Ww, Rd, Gg, Gs^Fp, Ww, Gg, Gg, Gs^Fp, Ww, Ww, Gg, Ww, Ww, Ww, Gg, Gs^Fp, Gg, Gs^Fp, Ww, Ww
Gg, Gg, Gg, Gg, Ss, Wwf, Wwf, Gg, Ww, Ww, Gg, Ww, Gg, Ww, Gs^Fp, Ww, Ww, Gg^Vh, Rd, Gg, Gg, Gs^Fp, Gg, Gs^Fp, Ww, Ww, Gs^Fp, Ww, Gs^Fp, Ww, Gs^Fp, Gs^Fp, Gg, Gs^Fp, Gs^Fp, Gs^Fp, Gs^Fp
Gg, Gg, Ww, Ss, Gg, Gg, Ww, Ww, Gg, Gg, Gg, Gg, Hh, Gs^Fp, Gs^Fp, Gg, Ww^Bw/, Rd, Ww, Ww, Ww, Gg, Ww, Ww, Re, Gg, Gs^Fp, Gs^Fp, Gg, Gs^Fp, Gg, Gg, Gs^Fp, Gg, Gg, Gs^Fp, Gs^Fp
Ww, Ww, Ss, Gg, Gg, Ww, Gg, Gg, Gg, Hh, Hh, Hh, Mm, Hh, Gg^Vh, Rd, Gs^Fp, Ww, Ss, Gg, Gs^Fp, Ww, Gg, Ww, Ww, Re, Re, Gg, Gg, Gs^Fp, Gs^Fp, Gs^Fp, Gs^Fp, Gs^Fp, Gg, Gg, Gg
Gs^Fp, Gs^Fp, Gg, Ss, Ss, Ww, Gg, Gs^Fp, Gs^Fp, Hh, Hh, Mm, Hh, Hh, Gs^Fp, Rd, Rd, Gg, Ss, Re, Re, Gs^Fp, Gs^Fp, Gg, Gs^Fp, Ww, Ww, Re, Gg, Gg, Gg, Gs^Fp, Gg, Gg, Gg, Gg, Gg
Gs^Fp, Gs^Fp, Gs^Fp, Gs^Fp, Gg, Ww, Ww, Gs^Fp, Gs^Fp, Gs^Fp, Gg, Hh, Gg^Es, Gg, Ww, Gg, Ww^Bw|, Ww, Re, Ss, Ss, Gs^Fp, Re, Gg^Vh, Gg, Gs^Fp, Ww, Re, Gg, Gg, Gg, Gg, Gg^Vh, Gs, Gg, Gg, Gg
Gg, Gg, Gg, Gs^Fp, Ww, Ww, Gg, Ww, Ww, Gs^Fp, Ww, Gg, Gg, Ww, Gs^Fp, Ww, Ww^Bw|, Ww, Chw, Chs, Chw, Ss, Gg, Gg, Gs^Fp, Gs^Fp, Ww, Gg, Gg, Gg, Hh, Gg, Gg, Gg, Hh, Hh, Hh
Ww, Ww, Ww, Ww, Gg, Gg, Gs^Fp, Gg, Gg, Ww, Gg, Ww, Ww, Ww, Gs^Fp, Gg, Rd, Gd^Vhr, Chr, 6 Kh, Chw, Chs, Ss, Gs^Fp, Ss, Ww, Re, Gg, Gg, Gg, Gg, Hh, Hh, Hh, Hh, Hh, Hh
Gg, Gg, Gs^Fp, Gg, Gs^Fp, Gs^Fp, Gs^Fp, Gs^Fp, Gs^Fp, Gs^Fp, Gs^Fp, Gs^Fp, Gg, Ww, Ww, Gs^Fp, Gd^Vhr, Rd, Gg, Chw, Ww, Gg, Gs^Fp, Ss, Re, Ww, Re, Re, Gs^Fp, Gg, Gg, Gg, Hh, Hh, Hh, Gg, Gg
Gs^Fp, Gs^Fp, Gg, Gs^Fp, Gg, Gg, Gs^Fp, Gs^Fp, Gg, Gs^Fp, Gs^Fp, Gs^Fp, Gs^Fp, Ww, Ww, Ww, Ww, Rd, Ww^Bw\, Ww, Ww, Gs^Fp, Ww, Gs^Fp, Ww, Ww, Gg, Gg, Gs^Fp, Gs^Fp, Gg, Hh, Gg, Gg, Gg, Gg, Gg
Gg, Gg, Gs^Fp, Gg^Vh, Gs^Fp, Gg, Gs^Fp, Ss, Gg, Gg^Vh, Gs^Fp, Ss, Gs^Fp, Gg, Ss, Gg, Re, Ww, Ww, Ww^Bw\, Rd, Ww, Ww, Ww, Gs^Fp, Gs^Fp, Gs^Fp, Gs^Fp, Gg, Gg, Gg, Gg, Ww, Ww, Ww, Ww, Ww
Gg, Gg, Gg, Gs^Fp, Gg, Ss, Gg, Gs^Fp, Gg, Gg, Gg, Gs^Fp, Ss, Gs^Fp, Ss, Gg, Gg, Ww, Gs^Fp, Gg, Rd, Gs^Fp, Gs^Fp, Gs^Fp, Gg, Gg, Gg, Gg, Ww, Ww, Ww, Ww, Gg, Gg, Gg, Gg, Gg
Gg, Gg, Gs^Fp, Gg, Gg, Gg, Gg, Gg^Efm, Gg, Gs^Fp, Gs^Fp, Gg, Gg, Gs^Fp, Gs^Fp, Gg^Es, Gg, Ww, Ww, Gg, Ww^Bw|, Gs^Fp, Ww, Gg, Ww, Gg, Ww, Ww, Gg, Ww, Gs^Fp, Gg, Gs^Fp, Gg, Gs^Fp, Gg, Gg
Gs^Fp, Gs^Fp, Gs^Fp, Gs^Fp, Gg, Gs^Fp, Gs^Fp, Gg, Gs^Fp, Gs^Fp, Gs^Fp, Gg, Gg, Gg, Gg, Gs^Fp, Gg, Gg, Gg, Ww, Rd, Ww, Gg, Ww, Gg, Ww, Gg, Gg, Gs^Fp, Gs^Fp, Gs^Fp, Gs^Fp, Gg^Vh, Gs^Fp, Gs^Fp, Gg, Gg
Gg, Gg, Gs, Gs^Fp, Gs^Fp, Gg, Gs^Fp, Gs^Fp, Gs^Fp, Gs^Fp, Gs^Fp, Gs^Fp, Rd, Gg, Gg^Vh, Gs^Fp, Rd, Rd, Rd, Gg, Rd, Gg^Vh, Gg, Gg, Gg, Gg, Gs^Fp, Gg, Gg^Vh, Gg, Gg, Gg, Gs^Fp, Gs^Fp, Gs^Fp, Gs^Fp, Gs^Fp
Gg, Gg, Rd, Gg^Vh, Rd, Gs^Fp, Rd, Gg, Rd, Rd, Rd, Rd, Gs^Fp, Rd, Rd, Rd, Gg, Gg, Gg, Rd, Gg, Rd, Gg, Gg, Gg, Gs^Fp, Gg, Gg, Gs^Fp, Gg, Gs^Fp, Gs^Fp, Gg, Gs^Fp, Gg^Gvs, Gg, Gg
Rd, Rd, Gs, Rd, Gg, Rd, Gs, Rd, Ss, Ww, Ww, Gg, Gg, Gs^Fp, Gg, Gg, Ce, Ce, Ce, Gg, Rd, Rd, Gg, Gg, Gs^Fp, Gs^Fp, Gg, Hh, Hh, Gs^Fp, Gs^Fp, Gg, Gs, Gs, Gg, Gg, Gg
Gg, Gg, Gg, Gg, Ce, Gg, Gg, Gs, Gg^Vh, Ss, Ss, Ww, Gg, Gs^Fp, Gg, Gg, Ce, 1 Ke, Ce, Rd, Gs^Vh, Gg, Gs^Fp, Gs^Fp, Gg, Gs^Fp, Hh, Mm, Hh, Gg, Gg, Gg, Gg, Gg^Vh, Rd, Rd, Rd
Gs^Fp, Gs^Fp, Gg, Ce, 2 Ke, Ce, Gg, Gs, Gg, Ss, Ss, Ww, Ww, Gg, Gg, Gg, Gg, Ce, Gg, Rd, Gg, Gg, Gs^Fp, Hh, Hh, Gs^Fp, Gg, Hh, Gs^Fp, Gg, Ce, Ce, Ce, Gg, Rd, Gs, Gs
Gs^Fp, Gs^Fp, Gg, Ce, Ce, Ce, Gg, Gg, Gg, Ss, Ss, Ww, Ww, Ss^Vhs, Ss, Gg, Gg, Gg, Gg, Rd, Gg, Gg, Gg, Gs^Fp, Gs^Fp, Gs^Fp, Rd, Gs^Fp, Rd, Gg, Ce, 3 Ke, Ce, Gg, Rd, Gs, Gs
Gg, Gg, Gg, Gg, Gg, Gg, Gd^Vhr, Gs^Fp, Gg, Gg, Ss, Ww, Ww, Ww, Ss, Gg, Gg, Gg, Gg^Vwm, Rd, Rd, Gg, Rd, Rd, Rd, Rd, Gs^Fp, Rd, Gg^Vh, Rd, Rd, Ce, Rd, Rd, Rd, Gg^Vh, Gg
Gs^Fp, Gs^Fp, Gs^Fp, Gs^Fp, Gs^Fp, Gg, Gs^Fp, Gs^Fp, Gg, Gs^Fp, Gs^Fp, Ww, Gg, Ss, Gg, Gg, Gg^Gvs, Gg^Gvs, Gg^Gvs, Gg, Rd, Rd, Gg, Gg, Gs^Fp, Gg, Gs^Fp, Gs^Fp, Gg, Gs^Gvs, Gg, Rd, Gg, Gg, Gg, Rd, Rd
Gs^Fp, Gs^Fp, Gs^Fp, Gs^Fp, Gs^Fp, Gg, Gs^Fp, Gs^Fp, Gg, Gs^Fp, Gs^Fp, Ww, Gg, Ss, Gg, Gg^Gvs, Gg^Gvs, Gg^Gvs, Gg, Gg, Rd, Rd, Gg, Gg, Gs^Fp, Gg, Gs^Fp, Gs^Fp, Gg, Gs, Gg, Rd, Gg, Gg^Es, Gg, Rd, Rd
