Gs^Fp, Gs^Fp, Gs^Fp, Gs^Fp, Gs^Fp, Gs^Fp, Gs^Fp, Gs^Fp, Gs^Fp, Gs^Fp, Gs^Fp, Gs^Fp, Gg, Gg, Gg, Gs^Fp, Gs^Fp, Gg, Gg, Gg, Gs^Fp, Gg, Gs^Fp, Gs^Fp, Gs^Fp, Gg, Gg, Gg, Gg, Gg, Gg, Gs^Fp, Gs^Fp, Gs^Fp, Gs^Fp, Gs^Fp, Gs^Fp
Gs^Fp, Gs^Fp, Gs^Fp, Gs^Fp, Gs^Fp, Gs^Fp, Gs^Fp, Gs^Fp, Gs^Fp, Gs^Fp, Gs^Fp, Gs^Fp, Gg, Gg, Gg, Gs^Fp, Gs^Fp, Gg, Gg, Gg, Gs^Fp, Gg, Gs^Fp, Gs^Fp, Gs^Fp, Gg, Gg, Gg, Gg, Gg, Gg, Gs^Fp, Gs^Fp, Gs^Fp, Gs^Fp, Gs^Fp, Gs^Fp
Gs^Fp, Gs^Fp, Rd, Gg, Rd, Gg, Gg^Vh, Gg, Gs^Fp, Gg, Gs^Fp, Gg, Ww, Ww, Ww, Gg, Gg, Gg, Gs^Fp, Gs^Fp, Gs^Fp, Gs^Fp, Gg, Gg, Gg, Gs^Fp, Gs^Fp, Gg, Gg, Gg, Rd, Rd, Rd, Gg, Gs^Fp, Gs^Fp, Gs^Fp
Rd, Rd, Gg, Rd, Ce, Rd, Rd, Gg, Gs^Fp, Gs^Fp, Gg, Gg, Ww, Ww, Ww, Gg, Gg, Gs^Fp, Gg, Gg, Gs^Fp, Gg, Gg, Gs^Fp, Rd, Gs^Fp, Gs^Fp, Gg, Rd, Rd, Ce, Ce, Ce, Rd, Gg, Gs^Fp, Gs^Fp
Gg, Gg, Gg, Ce, 4 Ke, Ce, Rd, Gg, Rd, Gg, Rd, Gg, Ss, Ww, Ss, Gg, Gg, Gs^Fp, Gg, Gg, Gg^Vh, Gs^Fp, Gs^Fp, Rd, Gs^Fp, Rd, Rd, Rd, Gg, Gg, Ce, 5 Ke, Ce, Rd, Rd, Gg^Vh, Gg
Gg, Gg, Gg, Ce, Ce, Ce, Gg, Rd, Gg^Vh, Rd, Gg, Rd, Rd, Ss, Gd^Vhr, Gg, Gs^Fp, Gs^Fp, Gs^Fp, Gg, Rd, Rd, Rd, Rd, Gs^Fp, Gg^Vh, Gs^Fp, Gs^Fp, Gg, Gg, Gg, Ce, Gg, Gg, Gg, Rd, Rd
Gs^Fp, Gs^Fp, Gg, Gg, Gg, Gg, Gg^Gvs, Gs, Gg, Gg, Gs^Fp, Gs^Fp, Gs^Fp, Rd, Rd, Gs^Fp, Rd, Rd, Rd, Rd, Gs^Fp, Gs^Fp, Gg, Gs^Fp, Gg, Gs^Fp, Gg, Gs^Fp, Gg, Gg, Gg, Gg, Gg, Gg, Gg, Gg, Gg
Gs^Fp, Gs^Fp, Gs^Fp, Gs^Fp, Gs^Fp, Gg, Gg, Gg, Gs^Fp, Gs^Fp, Gg, Gs^Fp, Gg, Gs^Fp, Gg, Rd, Gg, Gg, Rd, Gg, Gg, Gg, Gg, Gg, Gg, Gg, Gg, Gs^Fp, Gg, Gg, Gg, Gg, Gg, Gg, Gg, Gg, Gg
Gs^Fp, Gs^Fp, Gs^Fp, Gs^Fp, Gs^Fp, Gs^Fp, Gs^Fp, Gs^Fp, Gg, Gg, Gg, Gg, Gg, Gg, Gg, Gg, Ww, Ww, Ww^Bw|, Ww, Ww, Gg, Ww, Ww, Ww, Gg, Gg, Gg, Gg, Gg, Ww, Ww, Ww, Ww, Ww, Gg, Gg
Gg, Gg, Gg, Gg, Gg, Gg, Gg, Gg, Gg, Gg, Ww, Gg, Ww, Gg, Ww, Gg, Ww, Ww, Rd^Esd, Gg^Esd, Gs^Fts, Ww, Gg^Esd, Gg^Es, Gs^Fts, Ww, Ww, Gg, Ww, Ww, Ww, Gg^Esd, Gs^Fts, Gg^Esd, Gs^Fts, Ww, Ww
Gg, Gg, Gg, Gg, Ss, Wwf, Wwf, Gg, Ww, Ww, Ds, Ww, Ds, Ww, Gs^Fts, Ww, Ww, Gs^Vdt, Rd^Esd, Gg^Esd, Gg^Esd, Gs^Fts, Gg^Esd, Gs^Fts, Ww, Ww, Gs^Fts, Ww, Gs^Fts, Ww, Gs^Fts, Gs^Fts, Gg^Esd, Gs^Fts, Gs^Fts, Gs^Fts, Gs^Fts
Gg, Gg, Ww, Ss, Gg^Es, Gg^Es, Ww, Ww, Ds, Ds, Dd^Do, Ds, Hd, Ds^Fts, Dd^Fts, Gg^Es, Ww^Bw/, Rd^Esd, Ww, Ww, Ww, Gg^Esd, Ww, Ww, Re^Esd, Gg^Esd, Gs^Fts, Gs^Fts, Gg^Esd, Gs^Fts, Gg^Esd, Gg^Esd, Gs^Fts, Gg^Esd, Gg^Esd, Gs^Fts, Gs^Fts
Ww, Ww, Ss, Gg^Es, Gg^Es, Ww, Ds, Ds, Dd, Hd, Hd, Hd, Md, Hd, Dd^Vdt, Rd^Es, Gs^Fts, Ww, Ss, Gg^Es, Gs^Fts, Ww, Gg^Esd, Ww, Ww, Re^Esd, Re^Esd, Gg^Esd, Gg^Esd, Gs^Fts, Gs^Fts, Gs^Fts, Gs^Fts, Gs^Fts, Gg^Esd, Gg^Esd, Gg^Esd
Gs^Fts, Gs^Fts, Gg^Es, Ss, Ss, Ww, Gg^Es, Gs^Fts, Dd^Fts, Hd, Hd, Md, Hd, Hd, Ds^Fts, Rd^Esd, Rd^Esd, Gg^Es, Ss, Re^Es, Re^Do, Gs^Fts, Gs^Fts, Gg^Esd, Gs^Fts, Ww, Ww, Re^Esd, Gg^Esd, Gg^Esd, Gg^Esd, Gs^Fts, Gg^Esd, Gg^Esd, Gg^Esd, Gg^Esd, Gg^Esd
Gs^Fts, Gs^Fts, Gs^Fts, Gs^Fts, Gg^Es, Ww, Ww, Gs^Fts, Gs^Fts, Dd^Fts, Ds, Hd, Ds^Esd, Ds^Es, Ww, Ds, Ww^Bw|, Ww, Re^Es, Ss, Ss, Gs^Fts, Re^Esd, Gs^Vdt, Gg^Esd, Gs^Fts, Ww, Re^Esd, Gg^Esd, Gg^Esd, Dd, Gg^Esd, Gs^Vdt, Gs^Esd, Dd, Dd, Dd
Gg^Es, Gg^Es, Gg^Es, Gs^Fts, Ww, Ww, Gg, Ww, Ww, Gs^Fts, Ww, Ds, Ds, Ww, Gs^Fts, Ww, Ww^Bw|, Ww, Chw, Chs, Chw, Ss, Gg^Esd, Gg^Esd, Gs^Fts, Gs^Fts, Ww, Gg^Esd, Gg^Esd, Dd, Hd, Dd, Dd, Dd, Hd, Hd, Hd
Ww, Ww, Ww, Ww, Gg, Gg, Gs^Fp, Gg, Gg, Ww, Gg, Ww, Ww, Ww, Gs^Fts, Gg^Esd, Rd^Esd, Gd^Vhr, Chr, 6 Kdr, Chw, Chs, Ss, Gs^Fts, Ss, Ww, Re^Esd, Gg^Esd, Gg^Esd, Dd, Dd, Hd, Hd, Hd, Hd, Hd, Hd
Gg, Gg, Gs^Fp, Gg, Gs^Fp, Gs^Fp, Gs^Fp, Gs^Fp, Gs^Fp, Gs^Fp, Gs^Fp, Gs^Fp, Gg, Ww, Ww, Gs^Fts, Gd^Vhr, Rd^Esd, Ds^Esd, Chw, Ww, Ds^Esd, Gs^Fts, Ss, Re^Es, Ww, Re^Esd, Re^Esd, Gs^Fts, Gg^Esd, Dd, Dd^Do, Hd, Hd, Hd, Dd, Dd
Gs^Fp, Gs^Fp, Gg, Gs^Fp, Gg, Gg, Gs^Fp, Gs^Fp, Gg, Gs^Fp, Gs^Fp, Gs^Fp, Gs^Fp, Ww, Ww, Ww, Ww, Rd^Esd, Ww^Bw\, Ww, Ww, Gs^Fts, Ww, Gs^Fts, Ww, Ww, Gg^Esd, Gg^Esd, Gs^Fts, Gs^Fts, Dd, Hd, Ds, Ds, Ds, Ds, Ds
Gg, Gg, Gs^Fp, Gg^Vh, Gs^Fp, Gg, Gs^Fp, Ss, Gg, Gg^Vh, Gs^Fp, Ss, Gs^Fp, Gg, Ss, Gg, Re, Ww, Ww, Ww^Bw\, Rd, Ww, Ww, Ww, Gs^Fts, Gs^Fts, Gs^Fts, Gs^Fts, Gg^Esd, Gg^Esd, Gg^Esd, Ds, Ww, Ww, Ww, Ww, Ww
Gg, Gg, Gg, Gs^Fp, Gg, Ss, Gg, Gs^Fp, Gg, Gg, Gg, Gs^Fp, Ss, Gs^Fp, Ss, Gg, Gg, Ww, Gs^Fts, Gg^Esd, Rd, Gs^Fts, Gs^Fts, Gs^Fts, Gg^Esd, Gd^Do, Gg^Es, Gg^Esd, Ww, Ww, Ww, Ww, Gg, Gg, Gg, Gg, Gg
Gg, Gg, Gs^Fp, Gg, Gg, Gg, Gg, Gg^Efm, Gg, Gs^Fp, Gs^Fp, Gg, Gg, Gs^Fp, Gs^Fp, Gg^Es, Gg, Ww, Ww, Gg^Esd, Ww^Bw|, Gs^Fts, Ww, Gg^Es, Ww, Gg^Esd, Ww, Ww, Gg, Ww, Gs^Fp, Gg, Gs^Fp, Gg, Gs^Fp, Gg, Gg
Gs^Fp, Gs^Fp, Gs^Fp, Gs^Fp, Gg, Gs^Fp, Gs^Fp, Gg, Gs^Fp, Gs^Fp, Gs^Fp, Gg, Gg, Gg, Gg, Gs^Fp, Gg, Gg, Gg, Ww, Rd, Ww, Gg, Ww, Gg, Ww, Gg, Gg, Gs^Fp, Gs^Fp, Gs^Fp, Gs^Fp, Gg^Vh, Gs^Fp, Gs^Fp, Gg, Gg
Gg, Gg, Gs, Gs^Fp, Gs^Fp, Gg, Gs^Fp, Gs^Fp, Gs^Fp, Gs^Fp, Gs^Fp, Gs^Fp, Rd, Gg, Gg^Vh, Gs^Fp, Rd, Rd, Rd, Gg, Rd, Gg^Vh, Gg, Gg, Gg, Gg, Gs^Fp, Gg, Gg^Vh, Gg, Gg, Gg, Gs^Fp, Gs^Fp, Gs^Fp, Gs^Fp, Gs^Fp
Gg, Gg, Rd, Gg^Vh, Rd, Gs^Fp, Rd, Gg, Rd, Rd, Rd, Rd, Gs^Fp, Rd, Rd, Rd, Gg, Gg, Gg, Rd, Gg, Rd, Gg, Gg, Gg, Gs^Fp, Gg, Gg, Gs^Fp, Gg, Gs^Fp, Gs^Fp, Gg, Gs^Fp, Gg^Gvs, Gg, Gg
Rd, Rd, Gs, Rd, Gg, Rd, Gs, Rd, Ss, Ww, Ww, Gg, Gg, Gs^Fp, Gg, Gg, Ce, Ce, Ce, Gg, Rd, Rd, Gg, Gg, Gs^Fp, Gs^Fp, Gg, Hh, Hh, Gs^Fp, Gs^Fp, Gg, Gs, Gs, Gg, Gg, Gg
Gg, Gg, Gg, Gg, Ce, Gg, Gg, Gs, Gg^Vh, Ss, Ss, Ww, Gg, Gs^Fp, Gg, Gg, Ce, 1 Ke, Ce, Rd, Gs^Vh, Gg, Gs^Fp, Gs^Fp, Gg, Gs^Fp, Hh, Mm, Hh, Gg, Gg, Gg, Gg, Gg^Vh, Rd, Rd, Rd
Gs^Fp, Gs^Fp, Gg, Ce, 2 Ke, Ce, Gg, Gs, Gg, Ss, Ss, Ww, Ww, Gg, Gg, Gg, Gg, Ce, Gg, Rd, Gg, Gg, Gs^Fp, Hh, Hh, Gs^Fp, Gg, Hh, Gs^Fp, Gg, Ce, Ce, Ce, Gg, Rd, Gs, Gs
Gs^Fp, Gs^Fp, Gg, Ce, Ce, Ce, Gg, Gg, Gg, Ss, Ss, Ww, Ww, Ss^Vhs, Ss, Gg, Gg, Gg, Gg, Rd, Gg, Gg, Gg, Gs^Fp, Gs^Fp, Gs^Fp, Rd, Gs^Fp, Rd, Gg, Ce, 3 Ke, Ce, Gg, Rd, Gs, Gs
Gg, Gg, Gg, Gg, Gg, Gg, Gd^Vhr, Gs^Fp, Gg, Gg, Ss, Ww, Ww, Ww, Ss, Gg, Gg, Gg, Gg^Vwm, Rd, Rd, Gg, Rd, Rd, Rd, Rd, Gs^Fp, Rd, Gg^Vh, Rd, Rd, Ce, Rd, Rd, Rd, Gg^Vh, Gg
Gs^Fp, Gs^Fp, Gs^Fp, Gs^Fp, Gs^Fp, Gg, Gs^Fp, Gs^Fp, Gg, Gs^Fp, Gs^Fp, Ww, Gg, Ss, Gg, Gg, Gg^Gvs, Gg^Gvs, Gg^Gvs, Gg, Rd, Rd, Gg, Gg, Gs^Fp, Gg, Gs^Fp, Gs^Fp, Gg, Gs^Gvs, Gg, Rd, Gg, Gg, Gg, Rd, Rd
Gs^Fp, Gs^Fp, Gs^Fp, Gs^Fp, Gs^Fp, Gg, Gs^Fp, Gs^Fp, Gg, Gs^Fp, Gs^Fp, Ww, Gg, Ss, Gg, Gg^Gvs, Gg^Gvs, Gg^Gvs, Gg, Gg, Rd, Rd, Gg, Gg, Gs^Fp, Gg, Gs^Fp, Gs^Fp, Gg, Gs, Gg, Rd, Gg, Gg^Es, Gg, Rd, Rd
