Gg, Gg, Gs^Fms, Gs^Fms, Gs^Fms, Gs^Fms, Gs^Fds, Gs^Fds, Gs^Fds, Gg, Gg, Gg, Gg, Gg, Gg^Fet, Rd, Gg^Fet, Gg, Gs^Fms, Gs^Fp, Gs^Fp, Gs^Fms, Gs^Fp, Gs^Fms, Gg, Gs^Fms, Gs^Fms, Gs^Fms, Gs^Fms
Gg, Gg, Gs^Fms, Gs^Fms, Gs^Fms, Gs^Fms, Gs^Fms, Gs^Fds, Gs^Fds, Gg, Gg, Gg, Gg, Gg, Gg, Rd, Gg, Gg, Gs^Fms, Gs^Fms, Gs^Fms, Gs^Fms, Gs^Fp, Gs^Fp, Gg, Gs^Fp, Gs^Fp, Gs^Fp, Gs^Fms
Gs^Fms, Gs^Fds, Gs^Fp, Gs^Fp, Gs^Fp, Gg^Vh, Gs^Fms, Gs^Fds, Gg, Gg, Ce, Ce, Ce, Gg, Gg, Rd, Gg, Gg, Gs^Fms, Gs^Fms, Gg, Gg, Gg, Hh, Hh, Gs^Fp, Hh, Gg, Gg
Gs^Fms, Gs^Fms, Gg^Vl, Gs^Fp, Gs^Fp, Gs^Fms, Gs^Fms, Gs^Fds, Gg, Gg, Ce, 1 Ke, Ce, Gg, Gg^Vh, Rd, Gg, Gs^Fds, Gg, Gg, Ww, Ww, Gg, Gg, Hh, Hh^Fp, Hh^Fp, Hh, Hh
Gs^Fp, Gs^Fp, Gs^Fp, Gs^Fp, Gs^Fms, Gs^Fms, Gs^Fms, Gs^Fds, Gg, Gg, Gg, Ce, Gg, Rd, Rd, Rd, Gg, Gs^Fds, Gg, Gg, Ww, Gg, Gg, Gg, Gg, Hh, Hh, Hh, Hh
Gs^Fp, Gs^Fp, Gs^Fp, Gs^Fms, Gs^Fms, Gs^Fms, Gs^Fms, Gg, Gg, Gg, Gg, Gg, Rd, Rd, Gg, Gg, Gs^Fds, Gs^Fds, Gg, Gg, Ww, Gg^Vh, Gg, Gs^Fms, Gs^Fms, Gg, Gs^Fp, Gg, Gg
Gs^Fp, Gs^Fms, Gg, Gg, Gs^Fms, Gs^Fms, Gs^Fds, Gg, Gg, Gs^Vh, Rd, Rd, Rd, Gg, Gg, Gs^Fds, Gs^Fds, Gs^Fds, Gg, Gg, Ww, Gg, Ww, Gg, Gg, Gs^Fp, Gs^Fp, Gs^Fp, Gs^Fms
Gs^Fp, Gs^Fp, Gg, Gs^Fms, Gg, Gg, Gg, Gg, Rd, Rd, Gg, Gg, Rd, Gg, Gg, Gg, Gg, Gg, Ww, Ww, Ww, Ww, Gs^Fds, Ww, Ww, Gg, Gg, Gg, Gg
Gs^Fms, Gs^Fms, Gs^Fms, Gs^Fms, Gg, Gg, Rd, Rd, Gg, Gg, Gs^Fms, Gs^Fms, Gg, Rd, Gg, Gg, Ww, Ww, Gg, Gg, Gg, Wwf, Gg, Gs^Fds, Gg, Ww, Ww, Gg, Gg
Gg, Gg, Gg, Gg, Gg^Vh, Rd, Gg, Gg, Hh, Hh, Gs^Fds, Gs^Fds, Gg, Rd, Ww^Bw\, Ww, Gg, Gg, Gs^Fds, Gs^Fds, Gg, Wwf, Hh, Gg, Gg, Gg, Gs^Fds, Ww, Ww
Gg, Gg, Gg, Gg, Rd, Rd, Gg, Gs^Fms, Gs^Fms, Gs^Fms, Ww, Ww, Ww, Gg, Ww, Rd, Rd, Gg, Gg, Gg, Gg, Hh, Hh, Gg, Gg, Gs^Fds, Gs^Fds, Gg, Gg
Ww, Ww, Ww, Gg, Ww^Bw|, Gg, Ww, Gg, Ww, Ww, Gs^Fms, Gs^Fds, Gs^Fms, Ww, Gg, Gg, Rd, Rd, Rd, Hh, Gg, Gg, Gg, Gg, Gg, Gg, Gs^Fds, Gg, Gg
Gg, Gg, Gg, Ww, Rd, Ww, Gg, Ww, Gg, Gg, Gg, Gs^Fms, Gg, Gg, Gg, Rd, Gg, Gg^Vh, Gg, Rd, Rd, Rd, Rd, Gg, Gg^Vh, Gg, Gg, Gs^Fds, Gs^Fds
Gg, Gg, Rd, Rd, Gg, Gg, Gg, Gg, Gg, Gg, Gs^Fp, Gs^Fp, Gs^Fp, Gg, Rd, Rd, Gg, Gg, Ce, Gg, Gg, Gg, Gg, Rd, Rd, Gg, Gg, Gg, Gg
Gg, Gg, Rd, Gg^Vh, Gg, Gg, Gs^Fms, Gs^Fms, Gg, Gg, Gg, Hh^Fp, Gs^Fp, Gg, Rd, Gg^Vh, Gg, Ce, 5 Ke, Ce, Gg, Hh^Fp, Hh^Fp, Gs^Fms, Gg, Rd, Gg, Gg^Es, Gg
Gs^Fms, Gs^Fms, Rd, Gg, Gs^Fms, Gs^Fms, Gg, Gg, Gg, Gg^Vl, Gg, Hh^Fp, Gs^Fp, Gg, Rd, Gg, Gg, Ce, Ce, Ce, Gg, Gs^Fp, Hh^Fp, Gs^Fms, Gg, Rd, Gg, Gg, Gg
Gs^Fp, Gs^Fms, Rd, Gg, Gg, Gs^Fms, Gs^Fms, Hh, Gs^Fp, Gg, Gs^Fp, Gs^Fp, Gg, Gg, Rd, Gg, Gg, Gg, Gg, Gg, Gg, Gg, Gs^Fp, Gg, Rd, Rd, Gg, Gg, Gg
Gg, Gg, Rd, Gg, Gg^Vh, Gg, Gg, Gs^Fp, Gg, Gs^Fp, Hh^Fp, Gs^Fp, Gs^Fp, Rd, Gg, Gg, Gg, Gg, Hh^Fp, Hh^Fp, Gg, Gg, Rd, Rd, Gg, Gg, Gg, Gs^Fds, Gs^Fms
Gg^Gvs, Gg^Gvs, Gg, Rd, Rd, Rd, Rd, Gg, Gg, Gs^Fp, Hh, Gs^Fp, Rd, Rd, Gg, Gg, Gs^Fp, Gs^Fp, Gg, Gg, Gg, Gg, Rd, Gg^Vh, Gg, Gg, Gs^Fms, Gs^Fms, Gs^Fp
Gg^Gvs, Gg^Gvs, Gg, Gg, Gg, Gg, Gg, Rd, Rd, Gs^Fp, Hh, Gs^Fp, Rd, Gg^Vh, Gg, Gg, Gs^Fp, Gg, Gs^Fp, Gg, Gs^Fms, Gg, Gg, Rd, Rd, Gs^Fds, Gs^Fp, Gs^Fms, Gs^Fp
Gg, Gg, Ce, Ce, Ce, Gg, Gg, Gg, Rd, Gs^Fp, Hh, Gs^Fp, Rd, Gg, Gg, Gg, Gg, Gs^Fp, Gg, Gs^Fms, Gg, Gg, Gs^Fms, Gg, Gg, Rd, Gg, Gs^Fp, Gs^Fp
Gg, Gg, Ce, 3 Ke, Ce, Gg, Gg, Gg^Vh, Rd, Gs^Fp, Gs^Fp, Gs^Fp, Rd, Gs^Fp, Gs^Fp, Gg, Gg, Gg, Gg^Vh, Gg, Gg, Gs^Fp, Gs^Fms, Gg, Gg, Rd, Gg^Vh, Gg, Gg
Gg, Gg, Gg, Ce, Gg, Gg, Gs^Fp, Rd, Gs^Fp, Gs^Fp, Gs^Fp, Rd, Gg^Vh, Gg, Gs^Fp, Gs^Fp, Gs^Fp, Gg, Gg, Gg, Gg, Gg, Gs^Fp, Gs^Fms, Gg, Rd, Gg, Gg, Gg
Gg, Gg, Gg, Gg, Gs^Fms, Gg, Gs^Fp, Rd, Rd, Gs^Fp, Gs^Fp, Rd, Gg, Gs^Fp, Gs^Fp, Gg, Gs^Fp, Gs^Fp, Gs^Fp, Gg, Gg, Gg, Gs^Fms, Gg, Gg, Rd, Rd, Gg, Gg
Gg, Gg, Gg, Gs^Fds, Gg, Gs^Fp, Gs^Fp, Gs^Fp, Rd, Gg, Ww, Rd, Rd, Gs^Fp, Gs^Fp, Gs^Fp, Gs^Fp, Gs^Fp, Gs^Fp, Gg, Gg, Gs^Fp, Gg, Gg, Gg, Gg, Rd, Gg, Gg
Gg, Gg, Ww, Ss, Ww, Gg, Gg, Gg, Ww, Ww^Bw\, Rd, Ww^Bw/, Wwf, Rd, Rd, Gg, Gg, Gs^Fp, Gg, Gs^Fp, Gg, Gg, Gg, Gg, Gg, Gg, Rd, Gg, Gg
Wwf, Wwf, Gg, Ww, Gg, Ww, Ww, Ww, Gg, Gg, Rd, Gg, Wwf, Gg, Gg, Rd, Rd, Gg, Gg^Vh, Gs^Fp, Gg, Gg, Gg, Gg, Gg, Gg^Vh, Rd, Gg, Gg
Gg, Gg, Gs^Fms, Gs^Fms, Gs^Fp, Gg, Gs^Fms, Gs^Fms, Gs^Fp, Rd, Gs^Fp, Gs^Fp, Gg, Wwf, Wwf, Gg, Gg, Rd, Rd, Gs^Fds, Gg, Gg, Ce, Ce, Ce, Gg, Rd, Gg, Gg
Gs^Fms, Gs^Fms, Gs^Fp, Gs^Fms, Gg, Gg, Gg, Gs^Fms, Gg^Vl, Rd, Gs^Fp, Gg, Hh, Hh, Hh, Wwf, Gg, Gg^Vh, Rd, Gg, Gg, Gg, Ce, 4 Ke, Ce, Gg, Rd, Gg, Gg
Gg, Gg, Gg, Gg^Vh, Gg, Gg, Gg, Gg, Rd, Rd, Gg, Hh, Hh, Hh^Fp, Gs^Fp, Gg, Gg, Gg, Gs^Fp, Rd, Rd, Gg, Gg, Ce, Gg, Gg, Rd, Gg, Gg
Gg^Gvs, Gg^Eff, Gg^Eff, Gg, Ce, Ce, Ce, Gg, Rd, Gg, Gg, Hh, Hh, Hh^Fp, Gs^Fp, Gs^Fp, Gs^Fp, Gs^Fp, Gg, Gg, Gg, Rd, Gg, Gg, Gg, Gg, Rd, Gg, Gg
Gg^Gvs, Gg^Gvs, Gg^Vwm, Gg, Ce, 2 Ke, Ce, Gg, Rd, Gg, Gs^Fp, Gg, Hh, Hh, Gs^Fp, Gs^Fp, Gs^Fp, Gs^Fp, Gg, Gg, Gg, Rd, Rd, Gs^Fp, Gs^Fp, Gs^Fp, Rd, Gg, Gg
Gg^Gvs, Gg^Gvs, Gg, Gg, Gg, Ce, Gg, Gg, Rd, Gg, Gs^Fp, Gg, Hh, Hh^Fp, Hh^Fp, Gs^Fp, Gs^Fp, Gs^Fp, Gg, Gg, Gs^Fp, Gg, Gg, Rd, Rd, Gs^Fp, Rd, Gg, Gg
Gs^Fms, Gs^Fms, Gs^Fms, Gg, Gg, Gg, Rd, Rd, Gg, Gg, Gs^Fp, Gg, Hh, Hh^Fp, Hh^Fp, Hh^Fp, Hh, Hh, Gg, Gg, Gs^Fp, Gs^Fp, Gg, Gs^Fp, Gg, Rd, Rd, Gg, Gg
Gs^Fp, Gs^Fp, Gs^Fp, Gs^Fms, Gg, Gg^Vh, Rd, Gg, Gg, Gs^Fp, Gg, Gg, Gg, Hh, Hh, Hh, Hh, Hh, Gg, Gg^Vl, Gs^Fp, Gs^Fp, Gg, Gs^Fp, Gs^Fp, Gg, Gg, Rd, Rd
Gg, Gg, Gs^Fms, Gs^Fms, Gg, Gg, Rd, Gg, Gg, Gs^Fp, Gs^Fp, Gs^Fp, Gg, Gg, Gg, Hh, Gg, Gg, Gg, Gs^Fp, Gs^Fp, Gs^Fp, Gg, Gg, Gg, Gs^Fp, Gs^Fp, Gg, Gg
Gg, Gg, Gs^Fms, Gs^Fms, Gg, Gg, Rd, Gg, Gg, Gs^Fp, Gs^Fp, Gs^Fp, Gg, Gg, Gg, Hh^Fmf, Gg, Gg, Gg, Gs^Fp, Gs^Fp, Gs^Fp, Gg, Gg, Gg, Gs^Fp, Gs^Fp, Gg, Gg
